WWWWWWWWWWWWWWWWWWWWWWWWWWWWWWWWWWWWWWWWWWWWWWWWWWWWWWWWWWWW
WWWWWWWWWWWWWWWWWWWWWWWWWWWWWWWWWWWWWWWWWWWWWWWWWWWWWWWWWWWW
WWWWWWWWWWWWWWWWWWWWWWWWWWWWWWWWWWWWWWWWWWWWWWWWWWWWWWWWWWWW
WWWWWWWWWWWWWWWWWWWWWWWWWWWWWWWWWWWWWWWWWWWWWWWWWWWWWWWWWWWW
WWWWWWWWWWWWWWWWWWWWWWWWWWWWWWWWWWWWWWWWWWWWWWWWWWWWWWWWWWWW
WWWWWWWWWWWWWWWWWWWWWWWWWWWWWWWWWWWWWWWWWWWWWWWWWWWWWWWWWWWW
WWWWWWWWWWWWWWWWWWWWWWWWWWWWWWWW WWWWWWWWWWWWWWWWWWWWWWWWWWW
WWWWWWWWWWWWWWWWWWWWW WWWWWWW WWWWWWWWWWWWWWWWWWWWWWWWWWWWWW
WWWWWWWWWWWWWWWWWWWW WWWWWWWWWWWWWWWWWWW WWWWWWWWWWWWWWWWWWW
WWWWWWWWWWWWWWWWWWWWWWWWWW.............WWWWWWWWWWWWWWWWWWWWW
WWWWWWWWWWWWWWWWW...FFFF........À..».......WWWWWWWWWWWWWWWWW
WWWWWWWWWWWWWWWW....FFFFFF.............FFFFFFFWWW WW WWWWWWW
WWWWWWWWWWWWWWW....FFFFFFFFFEEEEE...FFFFF»FFFFFFWWWWWWWWWWWW
WWWWWWWWWWWWWW.....FFFFFFFEEEEEEEEFFFFFFFFF…FFFFWWW WWWWWWWW
WWWWWWWWWWW WW....EEEEEEEEEEEEEEEEEEEEEEEEEEE…FFFWWWWWWWWWWW
WWWWWWWWWWWWWW....E.....FFFFCY............D.EF…FFFWWWWWWWWWW
WWWWWWWWWW WWW....E.......FFYC..2.2.2..FFFFFEFFFFFWWWWWWWWWW
WWWWWWWWWWWWW...ÀFE....NN....D.........FFMXMEFFFFFFWWWWWWWWW
WWWWWWWWWWWW....FFE....DN...................EFFFFFFFWWWWWWWW
WWWWWWWWWWWW...FFFE.g...N...................EFF…»FFFFWWWWWWW
WWWWWWWWWWWW..…FFFE...g...FFFFFM............EFFFFFFFFWWWWWWW
WWWWWWWWWWW...FFFFEg......FFFFFXMXM....TTT.FEFF…NNNNNNWWWWWW
WWWWWWWWWWW..FFF»FE..g...DX...g..DM........FEFFFNYBBCNWWWWWW
WWWWWWWWWWW.F…F…FFE....XMXM.g.........g.g..FEFFFNB..BNWWWWWW
WWWWWWWWWWWFFFFEEEE....M.......g...........FEFFFNB..BNWWWWWW
WWWWWWWWWWWF»FFEFFFFFFFFF....g...EEEE.g.g..FEFFFNCBBYNWWWWWW
WWWWWWWWWWWFFFFEFFFFFFFFF........TDFF...N..FEFFFNNNNNNWWWWWW
WWWWWWWWWWFFFFFED..g.gTWWWWCD......FF..CN...EFFFF…FFWWWWWWWW
WWWWWW WWWFFFFFE.......WWWWY..g....FF..DNY..E»FFFFFWW WWWWWW
WWWWWWWW WFFFFFE...g.g.WWD..g......FF...N...EFFFFF…WWWWWWWWW
WWWWWWWWW…FFFFFE...N...FF......g..DWW.g.g...EFFFFFW WWWWWWWW
WWWWWW WWFFFFF»E..YND..FF....g..YWWWW.......EFFFFFWWW WWWWWW
WWWWWWWWFF…FFFFE...NC..FF......DCWWWWTg.g..DEFFFFFWWWWWWWWWW
WWWWWWNNNNNNFFFEF..N...FFDT........FFFFFFFFFEFFFFWWWWWWWWWWW
WWWWWWNYBBCNFFFEF..g.g.EEEE...g....FFFFFFFFFEFF»FWWWWWWWWWWW
WWWWWWNB..BNFFFEF...........g.......M....EEEEFFFFWWWWWWWWWWW
WWWWWWNB..BNFFFEF..g.g.........g.MXMX....EFF…F…F.WWWWWWWWWWW
WWWWWWNCBBYNFFFEF........MD..g...XD...g..EF»FFF..WWWWWWWWWWW
WWWWWWNNNNNN…FFEF.TTT....MXMXFFFFF......gEFFFF...WWWWWWWWWWW
WWWWWWWFFFFFFFFE............MFFFFF...g...EFFF…..WWWWWWWWWWWW
WWWWWWWFFFF»…FFE...................N...g.EFFF...WWWWWWWWWWWW
WWWWWWWWFFFFFFFE...................ND....EFF....WWWWWWWWWWWW
WWWWWWWWWFFFFFFEMXMFF.........D....NN....EFÀ...WWWWWWWWWWWWW
WWWWWWWWWWFFFFFEFFFFF..1.1.1..CYFF.......E....WWW WWWWWWWWWW
WWWWWWWWWWFFF…FE.D............YCFFFF.....E....WWWWWWWWWWWWWW
WWWWWWWWWWWFFF…EEEEEEEEEEEEEEEEEEEEEEEEEEE....WW WWWWWWWWWWW
WWWWWWWW WWWFFFF…FFFFFFFFFEEEEEEEEFFFFFFF.....WWWWWWWWWWWWWW
WWWWWWWWWWWWFFFFFF»FFFFF...EEEEEFFFFFFFFF....WWWWWWWWWWWWWWW
WWWWWWW WW WWWFFFFFFF.............FFFFFF....WWWWWWWWWWWWWWWW
WWWWWWWWWWWWWWWWW.......»..À........FFFF...WWWWWWWWWWWWWWWWW
WWWWWWWWWWWWWWWWWWWWW.............WWWWWWWWWWWWWWWWWWWWWWWWWW
WWWWWWWWWWWWWWWWWWW WWWWWWWWWWWWWWWWWWW WWWWWWWWWWWWWWWWWWWW
WWWWWWWWWWWWWWWWWWWWWWWWWWWWWW WWWWWWW WWWWWWWWWWWWWWWWWWWWW
WWWWWWWWWWWWWWWWWWWWWWWWWWW WWWWWWWWWWWWWWWWWWWWWWWWWWWWWWWW
WWWWWWWWWWWWWWWWWWWWWWWWWWWWWWWWWWWWWWWWWWWWWWWWWWWWWWWWWWWW
WWWWWWWWWWWWWWWWWWWWWWWWWWWWWWWWWWWWWWWWWWWWWWWWWWWWWWWWWWWW
WWWWWWWWWWWWWWWWWWWWWWWWWWWWWWWWWWWWWWWWWWWWWWWWWWWWWWWWWWWW
WWWWWWWWWWWWWWWWWWWWWWWWWWWWWWWWWWWWWWWWWWWWWWWWWWWWWWWWWWWW
WWWWWWWWWWWWWWWWWWWWWWWWWWWWWWWWWWWWWWWWWWWWWWWWWWWWWWWWWWWW
WWWWWWWWWWWWWWWWWWWWWWWWWWWWWWWWWWWWWWWWWWWWWWWWWWWWWWWWWWWW