WWWWWWWWWWWWWWWWWWWWWWWWWWWWWWWWWWWWWWWWWWWWWWWWWWWWWWWWWWWW
WWWWWWWWWWWWWWWWWWWWWWWWWWWWWWWWWWWWWWWWWWWWWWWWWWWWWWWWWWWW
WWWWWWWWWWWWWWWWWWWWWWWWWWWWWWWWWWWWWWWWWWWWWWWWWWWWWWWWWWWW
WWWWWWWWWWWWWWWWWWWWWWWWWWWWWWWWWWWWWWWWWWWWWWWWWWWWWWWWWWWW
WWWWWWWWWWWWWWWWWWWÊWWWWWWWWWWWWWWWWWWWWWWWWWWWWWW.WWWWWWWWW
WWWWWÊWWWWWWWWWWWWWWWWWWWWWWWWWWWWWWWWWWWWWWWÊWWW.É.WWWWWWWW
WWWWWWWWWWWWWWWWWWWWWWWWWWÊWW..WWWWWWWWWWWWWWWWW.....WWWWWWW
WWWWWWWWWWWWWWWWWWWWWWWWWWWW..É.WWÊWWWWWWWWWWWW.É...É.WWWWWW
WWWWWWWWWWWWWWWWWWWWWWWWWWW.FÉ...WWWWWWWWWWWWWWW..É..WWWWÊWW
WWWWWWWWWWWWWWWWWWWWWWWWWW.É..É.É.WWWWWWWWWWWWWWW...WWWWWWWW
WWWWWWWWWWWWWWWWWWWWWWWWW...FF.F.F.WWWWWWWWWÊWWWWW.WWWWWWWWW
WWWWWWWWWWWWWWWWWWWWWWWW..EEEEEEEE..WWWWWWWWWWWÊWWWWWWWWWWWW
WWWWWWWWW.WWWÊWWWWWWWWW..EEFFFFFFEE..WWWWWWWWWWWWWWWWWWWWWWW
WWWWWWWW.É.WWWWWWWWWWW..EEFFFFFFFFEE..WWWWWWWWWWWWWWWWWWWWWW
WWWWWWW.....WWWWWWWWW..EE....II....EE..WWWWWWWWWWWWWWWWWWWWW
WWWWÊWWW.É.WWWWWWWWW..EE.....II.....EE..WWWWWWWWWWWWWWWWWWWW
WWWWWWWWW.WWWWÊWWWW..EE..............EE..WWWWWWWWWWWWWWWWWWW
WWWWWWWWWWWWWWWWWW..EE..D.............EE..WWWWWWWWWWWWWWWWWW
WWWWWWWWWWWWWWWWW..EE.DD..C......D.....EE..WWWWWWWWWWWWWWWWW
WWWWWWWWWWWWWWWW..EED..D.CIIXFFXII......EE..WWWWWWWWWWWWWWWW
WWWWWWWWWWWWWWW..EE.......IIFFFFII.......EE..WWÊWWWWWWÊWWWWW
WWWWWWWWWWWWWW..EE...D..D.WW..g.C..g.g....EE..WWWWWWWWWWWWWW
WWWWWWWWWWWWW..EE..D......WWg.............DEE..WWWWWWWWWWWWW
WWWWWWWWWWWW..EE........g.M....g...g.gFY....EE..WWWWWWWWWWWW
WWWWWWWWWWW..EED....FY.g..M..g...C...FFY.....EE..WWWWWWWWWWW
WWWWWWWWWW..EED.D..FFM....II....IIXXXMMM....D.EE..WWWÊWWWWWW
WWWWWWÊWW.FEE.....FFFM..g.II....IIFF...........EE..WWWWWWWWW
WWWWWWWW.FFED..1..IaaM.g....D..D.NF..g........D.E.É.WWWÊWWWW
WWWWWWW..É.ED.D...ID......D...gD.N.g...D.I..2...EF.F.WWWWWWW
WWWWWW..F.FEDD.1..I.....g...gD...N...g..DI...D.DEF..É.WWWWWW
WWWWWW.É.ÉFEDD....I.D.g...N..DDg...g...DDI..2..DE.É...WWWWWW
WWWWWWW.F.FED..1..I.....g.N.Dg.D........DI..D.D.EF.F.WWWWWWW
WWWWWWWW.É.E..........g..FN.........g.MaaI..2..DE.É.WWWWWWWW
WWWWWWWWW.FEE..D........FFII....II.g..MFFF.....EEF.WWWWWÊWWW
WWWWWWWWWW..EE......MMMXXXII....II....MFF....DEE..WWWWWWWWWW
WWWWWWWWWWW..EE....DYFF...C...g..M..g.YF...D.EE..WWWWWWWWWWW
WWWWWWWWWÊWW..EE....YFg.g...g....M.g.......DEE..WWWWWWWWWWWW
WWWWWWWWWWWWW..EE..............gWW...D..D..EE..WWWWWWWWWWWWW
WWWWWWWWWWWWWW..EE....g.g..C.g..WW..DD.D..EE..WWWWWWWWWWWWWW
WWWWWWWWWWWWWWW..EE.......IIFFFFII...D...EE..WWWWWWWWWWWWWWW
WWWWWWWWWWWWWWWW..EE......IIXFFXIICD....EE..WWWWWWWWWWWWWWWW
WWWWWWWWWWWWWWWWW..EE............C.....EE..WWWWWWWWWWWWWWWWW
WWWWWWWWWWWWWWWWWW..EE............D...EE..WWWWWWWWWWWWWWWWWW
WWWWWWWWWWWWWWWWWWW..EE..............EE..WWWWWWWWWWWWWWWWWWW
WWWWWWWWWWWWWWWWWWWW..EE.....II.....EE..WWWWWWWWWWWWWWWWWWWW
WWWWWWWWW..WWÊWWWWWWW..EE....II....EE..WWWWWWWWWWWWWWWWWWWWW
WWWWWWWW.É..WWWWWWWWWW..EEFFFFFFFFEE..WWWWWWWWWWWWWWWWWWWWWW
WWWWWWW....É.WWWWWWWWWW..EEFFFFFFEE..WWWWWWÊWWWWWWWWWWWWWWWW
WWWWWW..É.F.F.WWWWWWWWWW..EEEEEEEE..WWWWWWWWWW.WWWWWWWWWWWWW
WWWWW.É...Ë..É.WWWWWWWWWW.FFF.FF.F.WWWWWWWWWW..FWWWWWWWWWWWW
WWWWW...F......WWWWWWWWWWW.É.É..É.WWWWWWWWWW..È.FWWWWWWWWÊWW
WWWWWW.É...É..WWWWWWWWWWWWW.F.É..WWWWWWWWWWWWF..WWWWWW.WWWWW
WWWWWWW...F..WWWWWWWWWWWWWWW.É..WWWWWWWWWWÊWWW.WWWWWW...WWWW
WWWWWWWW.É..WWWWWWWWWWWWWWWWW..WWWWÊWWWWWWWWWWWWWWWW..É..WWW
WWWWWÊWWW..WWWWÊWWWWWWWWWWWWWWWWWWWWWWWWWWWWWÊWWWWWWW...WWWW
WWWWWWWWWWWWWWWWWWWWWWWWÊWWWWWWWWWWWWWWWWWWWWWWWWWWWWW.WWWWW
WWWWWWWWWWWWWÊWWWWWWWWWWWWWWWWWWWWWWWWWWWWWWWWWWWWWWWWWWWWWW
WWWWWWWWWWWWWWWWWWWWWWWWWWWWWWWWWWWWWWWWWWWWWWWWWWWWWWWWWWWW
WWWWWWWWWWWWWWWWWWWWWWWWWWWWWWWWWWWWWWWWWWWWWWWWWWWWWWWWWWWW
WWWWWWWWWWWWWWWWWWWWWWWWWWWWWWWWWWWWWWWWWWWWWWWWWWWWWWWWWWWW