WWWWWWWWWWWWWWWWWWWWWWWWWWWWWWWWWWWWWWWWWWWWWWWWWWWWWWWWWWWW
WWWWWWWWWWWWWWWWWWWWWWWWWWWWWWWWWWWWWWWWWWWWWWWWWWWWWWWWWWWW
WWWWWWWWWWWWWWWWWWWWWWWWWWWWWWWWWWWWWWWWWWWWWWWWWWWWWWWWWWWW
WWWWWWWWWWWWWWWWWWWWWWWWWWWWWWWWWWWWWWWWWWWWWWWWWWWWWWWWWWWW
WWWWWWWWWWWWWWWWWWWWWWWWWWWWWWWWWWWWWWWWWWWWWWWWWWWWWWWWWWWW
WWWWWWWWWWWWWWWWWWWWWWWWWWWWWWWWWWWWWWWWWWWWWWWWWWWWWWWWWWWW
WWWWWWWWWWWWWWWWWWWWWWWWWWWWFFFFWWWÊWWWWWWWWWWWWWWWWWWWWWWWW
WWWWWWWWWWWWWWWWWWWWWWWWFFFFFFFFFWWWWWWWWWWWWWWWWWWWWWWWWWWW
WWWWWWWWWWWWWWWWWWWWWWWFFÉFÈFFFFFFFF.....WWÊWWWWWWWWWWWWWWWW
WWWWWWWWWWWWWÊWWWW....FFFFFFFFËFFFFÉF.....WWWWWWWWWWWWWWWWWW
WWWWWWWWWWWÊWWWWW....FFÉFFFFFFFFÈFFFÉF.....WWWÊWWWWWWWWWWWWW
WWWWWWWWWWWWWWWW....CEEEEEEEEEEEEEEEEEEY....WWWWWWWWWWWWWWWW
WWWWWWWWWWWWWW....YCYE....YCD....CY...ECYC...WWWWWWWWWWWWWWW
WWWWWWWWWWWWW.....CYCE................EYCY....WWWWWWWWWWWWWW
WWWWWWWWWWWWW....CYCYE......2.2.2.....ECYCY...WWWWWWWWWWWWWW
WWWWWWWWWWWWW....EEEEECY.............YEEEEE....WWWWWWWWWWWWW
WWWWWWWWWWÊW.....E...CY..............CY...E....WWWWWWWWWWWWW
WWWWWWWWWWWW.....E..........FFFFD.........E....WWWWWWWWWWWWW
WWWWWWWWWWW.....FE.g.g......FFFF......g.g.EF...WWWWWWWWWWWWW
WWWWWWWWWWW....ÈFE..........TCYT..........EFFF.WWWWWWWWWWWWW
WWWWWWWWWWW..ÈFFFE.g.g.XM....EE.......g.g.EFFFFWWWWWWWWWWWWW
WWWWWWWWWW....FFFE......XM................EFFFFWWÊWWWWWWWWWW
WWWWWWWWWW...FFFFEEE........g......FFFFFEEEFÉFFFWWWWWWWWWWWW
WWWWWWWÊWW..ËFFFFFFEEF....g......D.FFFFEEFFFFFFFWWWÊWWWWWWWW
WWWWWWWWWW...FFFFFFEEF.......g..EET.FFFEEFFFFFFFWWWWWWWWWWWW
WWWWWWWWWW....FÉFÉFEEF..FFFg.........FFEEFÈFFFÉFWWÊWWWWWWWWW
WWWWWWWWÊW....YCEEEE....MXF...........FFEEEEFÉFF.WWWWWWWWWWW
WWWWWWWWWW....CYE........MXT...............EFFF..WWWWWWWWWWW
WWWWWWWWWW....YCE.g.g.........g..DEE......DEFF....WWWWWWWWWW
WWWWWWWWWW....CYE...........g.....CYT..g.g.EFF....WWWWWWWWWW
WWWWWWWWWW....FFE.g.g..TYC.....g...........EYC....WWWWWWWWWW
WWWWWWWWWW....FFED......EED..g.........g.g.ECY....WWWWWWWWWW
WWWWWWWWWWW..FFFE...............TXM........EYC....WWWWWWWWWW
WWWWWWWWWWW.FFÉFEEEEFF...........FXM....EEEECY....WÊWWWWWWWW
WWWWWWWWWÊWWFÉFFFÈFEEFF.........gFFF..FEEFÉFÉF....WWWWWWWWWW
WWWWWWWWWWWWFFFFFFFEEFFF.TEE..g.......FEEFFFFFF...WWWWWWWWWW
WWWWWWWWÊWWWFFFFFFFEEFFFF.D......g....FEEFFFFFFË..WWÊWWWWWWW
WWWWWWWWWWWWFFFÉFEEEFFFFF......g........EEEFFFF...WWWWWWWWWW
WWWWWWWWWWÊWWFFFFE................MX......EFFF....WWWWWWWWWW
WWWWWWWWWWWWWFFFFE.g.g.......EE....MX.g.g.EFFFÈ..WWWWWWWWWWW
WWWWWWWWWWWWW.FFFE..........TYCT..........EFÈ....WWWWWWWWWWW
WWWWWWWWWWWWW...FE.g.g......FFFF......g.g.EF.....WWWWWWWWWWW
WWWWWWWWWWWWW....E.........DFFFF..........E.....WWWWWWWWWWWW
WWWWWWWWWWWWW....E...YC..............YC...E.....WÊWWWWWWWWWW
WWWWWWWWWWWWW....EEEEEYC............YCEEEEE....WWWWWWWWWWWWW
WWWWWWWWWWWWWW...YCYCE.....1.1.1......EYCYC....WWWWWWWWWWWWW
WWWWWWWWWWWWWW....YCYE................ECYC.....WWWWWWWWWWWWW
WWWWWWWWWWWWWWW...CYCE...YC....DCY....EYCY....WWWWWWWWWWWWWW
WWWWWWWWWWWWWWWW....YEEEEEEEEEEEEEEEEEEC....WWWWWWWWWWWWWWWW
WWWWWWWWWWWWWÊWWW.....FÉFFFÈFFFFFFFFÉFF....WWWWWÊWWWWWWWWWWW
WWWWWWWWWWWWWWWWWW.....FÉFFFFËFFFFFFFF....WWWWÊWWWWWWWWWWWWW
WWWWWWWWWWWWWWWWÊWW.....FFFFFFFFÈFÉFFWWWWWWWWWWWWWWWWWWWWWWW
WWWWWWWWWWWWWWWWWWWWWWWWWWWFFFFFFFFFWWWWWWWWWWWWWWWWWWWWWWWW
WWWWWWWWWWWWWWWWWWWWWWWWÊWWWFFFFWWWWWWWWWWWWWWWWWWWWWWWWWWWW
WWWWWWWWWWWWWWWWWWWWWWWWWWWWWWWWWWWWWWWWWWWWWWWWWWWWWWWWWWWW
WWWWWWWWWWWWWWWWWWWWWWWWWWWWWWWWWWWWWWWWWWWWWWWWWWWWWWWWWWWW
WWWWWWWWWWWWWWWWWWWWWWWWWWWWWWWWWWWWWWWWWWWWWWWWWWWWWWWWWWWW
WWWWWWWWWWWWWWWWWWWWWWWWWWWWWWWWWWWWWWWWWWWWWWWWWWWWWWWWWWWW
WWWWWWWWWWWWWWWWWWWWWWWWWWWWWWWWWWWWWWWWWWWWWWWWWWWWWWWWWWWW
WWWWWWWWWWWWWWWWWWWWWWWWWWWWWWWWWWWWWWWWWWWWWWWWWWWWWWWWWWWW