FFFFFFFFFFFFFFFFFFFFFFFFFFFFFFFFFFFFFFFFFFFFFFFFFFFFFFFFFFFF
FFFFFFFFFFFFFFFFFFFFFFFFFFFFFFFFFFFFFFFFFFFFFFFFFFFFFFFFFFFF
FFFFFFFFFFFFFFFFFFFFFFFFFFFFFFFFFFFFFFFFFFFFFFFFFFFFFFFFFFFF
FFFFFFFFFFFFFFFF.FFFFFFFFFF..FFFFFFFFFFFFFFFFFFFFFFFFFFFFFFF
FFFFFFF..FFFFFFFFFFFFFFFFFF..FFFFFFFFFFFFFFFFFFFFFFFFFFFFFFF
FFFFF..É...FFFFFFFFFFFFFFFFFFFFFFFFFFFFFFFFFFFFFFFFFFFFFFFFF
FFFF........FFFFFFFFFFFFFFFFFFFFF.FFFFFFFFFF...FFFFFFFFFFFFF
FFFF..É..É..FFFFFFFF..FFFFFFFFFFFFFFFFFFFFF.É.É.FFFFFFFFFFFF
FFF.É........FFFFFF.É..FFFFFFFFFFFFFFFFFFFF.....FFFFFFFFFFFF
FFF....É.....FFFFFF..É.FFFFFFFFFFFFFFFFFFFF..É..FFFFFFFFFFFF
FFFF......É.FFFFFFFF..FFFFFFFFFFFFFFFFFFFFFF...FFFFFF.FFFFFF
FFFF.É..É...FFFFFFFFFFFFFFFFFFFFFFFFFFFFFFFFFFFFFFFF.É.FFFFF
FFFFF......FFFFFFFFFFFFFFFFEEEEEEFFFFFFFFFFFFFFFFFFFF.FFFFFF
FFFFFFF..FFFFFFFFFFFFFFEEEEE....EEEEEFFFFFFFFFFFFFFFFFFFFFFF
FFFFFFFFFFFFFFFFFFFFFEEE............EEEFFFFFFFFFFFFFFFFFFFFF
FFFFFFFFFFFFFFFFFFFEEE.....2.2.2......EEEFFFFFFF.FFFFFFFFFFF
FFFFFFFFFFFFFFFFFFEE....................EEFFFFFFFFFFFFFFFFFF
FFFFFFFFFFFFFFFFFEE.........FFFF.........EEFFFFFFFFFFFFFFFFF
FFFFFFFFFF..FFFFEE.........EEEEEE.........EEFFFFFFFFFFFFFFFF
FFFFFFFFFF..FFFEE.........YE....EY.........EEFFFFFFFFFFF.FFF
FFFFFFFFFFFFFFFE....NN........g.......NN....EFFFFFFFFFFFFFFF
FFFFF.FFFFFFFFEE...FN......g.g..g......NF...EEFFFFFFFFFFFFFF
FFFFFFFFFFFFFFE...NNN.g.g..........g.g.NNN...EFFFF..FFFFFFFF
FFFFFFFFFFFFFEE...N.......MMFFFEE........N...EEFF..É.FFFFFFF
FFFFFFFFFFFFFE.......g.g............g.g.......EFF.É..FFFFFFF
FFFFFFFFFFFFFE................................EFFF..FFFFFFFF
FFFFFFFFFFFFFEXX......EEEEEaa....aaYFFEEE....YEFFFFFFFFFFFFF
FFFF...FFFFFEEFF..g...YFFFE.........FFFFY.....EEFFFFFFFFFFFF
FFF.É...FFFFE.......g...FFE.g..................EFFFFFFFFFFFF
FFF...É.FFFFE...MMg......FY....g.........gFF...EFFFFFFFFFFFF
FFF.É...FFFFE...FF..g.......g....YF....g..MM...EFFFFFF.FFFFF
FFFF...FFFFFE..................g.EFF.....g.....EFFFFFFFFFFFF
FFFFFFFFFFFFEE.....YFFFF.........EFFFY.g....FFEEFFFFFFFFFFFF
FFFFFFFFFFFFFEY....EEEFFYaa....aaEEEEE......XXEFFFFFFFFFFFFF
FFFFFFFFFFFFFE................................EFFFFFFFFFFFFF
FFFFFFFFFFFFFE......g.g..............g.g......EFFFFF...FFFFF
FFFF.FFFFFFFFEE...N........EEFFFMM.......N...EEFFFF...É.FFFF
FFFFFFFFFFFFFFE...NNN.g.g..........g.g.NNN...EFFFF..É....FFF
FFFFFFFFFFFFFFEE...FN......g..g.g......NF...EEFFFF....É..FFF
FFFFFFFFFFFFFFFE....NN.......g........NN....EFFFFF.É.....FFF
FFFFFFFFFFFFFFFEE.........YE....EY.........EEFFFFFF..É..FFFF
FFFFFFFFFFFFFFFFEE.........EEEEEE.........EEFFFFFFFF...FFFFF
FFFFFFFFFF..FFFFFEE.........FFFF.........EEFFF.FFFFFFFFFFFFF
FFFFFFFFF....FFFFFEE....................EEFFFFFFFFFFFFFFFFFF
FFFFFFFFF.É..FFFFFFEEE......1.1.1.....EEEFFFFFFFFFFFFFFFFFFF
FFFFFFFFFF..FFFFFFFFFEEE............EEEFFFFFFFFFFFFFFFFFFFFF
FFFFFFFFFFFFFFFFFFFFFFFEEEEE....EEEEEFFFFFFFFFFFFFFFFFF..FFF
FFFFFFFFFFFFFFFFFFFFFFFFFFFEEEEEEFFFFFFFFFFFFFFFFFFFFFF..FFF
FFFFFFFFFFFFFFFFFFFFFFFFFFFFFFFFFFFFFFFFFFFFFF..FFFFFFFFFFFF
FFFFFFFFFFFFFFFFFFFFFFFFFFFFFFFFFFFFFFFFFFFFF..É.FFFFFFFFFFF
FFFFFFFFFFFFFFFFFFFFFFFFFFFFFFFFFFFFFFFFFFFFF.É..FFFFFFFFFFF
FFFF..FFFFFFFFFFFFFFFFFFFFFFFFFFFFFFFFFFFFFFFF..FFFFFFFFFFFF
FFFF..FFFFFFFFFFFFFFFFFFFFFFFFFFFFFFFFFFFFFFFFFFFFFFFFFFFFFF
FFFFFFFFFFFFFFF.FFFFFFFFFFFF..FFFFFF.FFFFFFFFFFFFFFFFFFFFFFF
FFFFFFFFFFFFFFFFFFFFFFFFFFF..É.FFFFFFFFFFFFFFFFFFFFFFFFFFFFF
FFFFFFFFFFFFFFFFFFFFFFFFFFF.É..FFFFFFFFFFFFFFFFFFF.FFFFFFFFF
FFFFFFFFFFFFFFFFFFF..FFFFFFF..FFFFFFFFFFFFFFFFFFFFFFFFFFFFFF
FFFFFFFFFFFFFFFFFFF..FFFFFFFFFFFFFFFFFFFFFFFFFFFFFFFFFFFFFFF
FFFFFFFFFFFFFFFFFFFFFFFFFFFFFFFFFFFFFFFFFFFFFFFFFFFFFFFFFFFF
FFFFFFFFFFFFFFFFFFFFFFFFFFFFFFFFFFFFFFFFFFFFFFFFFFFFFFFFFFFF