FFFFFFFFFFFFFFFFFFFFFFFFFFFFFFFFFFFFFFFFFFFFFFFFFFFFFFFFFFFF
FFFFFF.FFFFFFFFFFFFFFFFFFFFFFFFFFFFFFFFFFFFFFFFFFFFFFFFFFFFF
FFFF......F.FFFFFFFFFFFFFFFFFFFFFFFFFFFFFFFFFFFFFFFFFFFFFFFF
FFF.É.FFF..É.FFFFFFFFFFFFFFFFFFFFFFFFFFFFFFFFFFFFFFFFFFFFFFF
FFFF...Ë....FFFFFFFFFFFÈFFFFFFFFFFFFFFFÈFFFFFFFFFFFFFFFFFFFF
FFF.É.....FFFFFFFFFFFFFFFFFFFFFFFFFFFFFFFFFFFFFFFFFÈFFFFFFFF
FFFF.....FFFFFFFFFEEEEEEEEEEEEEEEEEEEEEEEEFFFFFFFFFFFFFFFFFF
FFFFFFFFFFFFFFFFFFEWWWWWWWWWWWWWWWWWWWWWWEFFFÈFFFFFFFFFFFFFF
FFFFFFFFFEEEEEEEEEEWWWWWWWWWWWWWWWWWWWWWWEFFFFFFFFFFFFFFFFFF
FFFFFFFFFEWWWWWWWWWWWWWWWWWWWWWWWWWWWWWWWEEEEEEEEEEFFFFFFFFF
FFFFFFFFFEWWWWWWWWWWWWWWWWWWWWWWWÊWWWWWWWWWWWWWWWWEFFFFF.FFF
FFFFFFEEEEWWWWWWWWWWWWWWWÊWWWWWWWWWWWWWWWWWWWWWWWWEFFFFFÈFFF
FFFFFFEWWWWWWWWWWWWWWWWWWWWWWWWWWWWWÊWWWWWWWWWWWWWEEEEFF.FFF
FFFFÈFEWWWWWWWWWWWWWWWWWWWWWWWWWWWWWWWWWWWWWWWWWWWWWWEFFFFFF
FFFFFFEWWWWWWWWWWÊWWWWWEEEEEEEEEEEEEEEEEEEEEWWWWWWWWWEEEEFFF
FFFFFFEWWWWWWWWWWWWWWWWE...DD....D..FFEWWWWEWWÊWWWWWWWWWEFFF
FFFFFFEWWWWWWWWWEEEEEEEE..D.........FFEWWÊWEWWWWWWWWWWWWEFFF
FFFFFFEWWWWWWWWWEWWWE.D...2.2.2.......EWWWWEWWWWWWWWWWWWEFFF
FFFFEEEWWWWWWWWWEWWWE....D....D.DDC...EEEEEEEEEEWWWWWWWWEFFF
FFFFEWWWWWWWWWWWEWWWE...........D.C.......DEWWWEWWWWWWWWEFFF
FFFFEWWWWWWWEEEEEEEEE...Y......EEEE...g....EEEEEEEEWWWWWEFFF
FFFFEWWWWWWWEWWWEFF.....Y..X...WW...g...g...D..FFFEWWWWWEF.F
FFFFEWWWWWWWEWÊWEFFg...YY..X...WW.....g........FFFEWWWWWEFÈF
FFFFEWWWWWWWEWWWE....g.....X..g..g.............FFFEWWWWWEF.F
FFFFEWWWWWWWEWÊWE.g........X.......CCE...WWW...EEEEWWWWWEFFF
FFFFEWWWWWWWEWWWE...g.FFFFFF..g..g.FFE...WWW...EWWWWWWWWEFFF
FFFFEWWWWWWWEEEEED....FFFFFF.......FFE...WWW..DEWWWWWWWWEFFF
FFFFEWWWWWWWE.........XXXXXIIIIII....E.g.MMM.DDEWÊWWWWWWEFFF
FF.FEWWWWWWWE.......g.........D......E.....M...EWWWWWWWWEFFF
FFÈFEWWWWWWWE.D.......g...gD.D.g...D...g...MD..EWWWWWWWWEFFF
FF.FEWWWWWWWE..DX...g....D..g.DDDg...g.......D.EWWWÊWWWEEFFF
FFFEEWWWWWWWE...X.....E......DD.D......g.......EWWWWWWWEFFFF
FFFEWWWWWÊWWEDD.XXX.g.E....IIIIIIMMMMM.........EWWWWWWWEFFFF
FFFEWWWWWWWWED..WWW...EFF.......FFFFFF....DEEEEEWWWWWWWEFÈ.F
FFFEWWWWWWWWE...WWW...EFF.g..g..FFFFFF.g...EWWWEWÊWWWWWEF.FF
FFFEWWWWWEEEE...WWW...EYY.......M........g.EWÊWEWWWWWWWEFFFF
FFFEWWWWWEFFF.............g..g..M.....g....EWWWEWWWWWWWEFFFF
FFFEWWWWWEFFF......g.g.....WW...M..CC...gFFEWÊWEWWWWWWWEFFFF
FFFEWWWWWEFFF..D.......g...WW...M..C.....FFEWWWEWWWWWWWEFFFF
FFFEWWÊWWEEEEEEEE....g...EEEE......C...EEEEEEEEEWWWWWWWEFFFF
FFFEWWWWWWWWEWWWED.......Y.D...........EWWWEWWWWWWWWWWWEFFFF
FFFEWWWWWWWWEEEEEEEEEE...YDD.D....D....EWWWEWWWWWWWWWWWEFFFF
FFFEWWWWWWWWWWWWEWWWWE.......1.1.1.....EWWWEWWWWWWWWWEEEFFFF
FFFEWWWWWWWWWWWWEWWÊWEFF.D......D...EEEEEEEEWWWWWWWWWEFFFFFF
FFFEEEEWWWWWWWWWEWWWWEFF...DD..DD.D.EWWWWWWWWWWWWWWWWEFFFFFF
FFFFFFEWWWWWWWWWEEEEEEEEEEEEEEEEEEEEEWWWWWWWWWWWWWWWWEFÈFFFF
FFFFFFEWWWWWWWWWWWWWWWWWWWWWWWWWWWWWWWWWWWWÊWWWWWWWWWEFFFFFF
FFFFÈFEEEEEEEWWWWWWWWWWWWWWWÊWWWWWWWWWWWWWWWWWWWWWWWWEFFFFFF
FFFFFFFFFFFFEWWWWWWWWWWWWWWWWWWWWWWWWWWWWWWWWWWWWWEEEEFFFFFF
FFFFFFFFFFFFEWWWWWWWWWWWWÊWWWWÊWWWWWWWWWWWWWWWWWWWEFFFFFFFFF
FFFFFFÈFFFFFEEEEEEEWWWWWWWWWWWWWWWWWWWWWWWWWWWWWWWEFFFFF.FFF
FFFFFFFFFFFFFFFFFFEWWWWWWWWWWWWWWWWWWWWWEEEEEEEEEEEFFFF.É.FF
FFFFFFFFFFFFF.FFFFEWWWWWWWWWWWWWWWWWWWWWEFFFFFFFFFFFFFFF.FFF
FFFFFFFFFFFFFÈFFFFEEEEEEEEEEEEEEEEEEEEEEEFFFFFFFFFFFFF..FFFF
FFFFFFFFFFFFF.FFFFFFFFFFFFFFFFFFFFFFFFFFFFFFFFFFFFFFF.....FF
FFFFFFFFFFFFFFFFFFFFFFFFFFFFFFFFFFFFFFFFFFFFFFFFFFFF...Ë..FF
FFFFFFFF.FFFFFFFFFFFFFFFFFFFFFFFFFÈFFFFFFFFFÈFFFFFF.É.....FF
FFFFFFFFÈFFFFFFFFFFÈFFFFFFFFFFFFFFFFFFFFFFFFFFFFFFFF.F...FFF
FFFFFFFF.FFFFFFFFFFFFFFFFFFFFFFFFFFFFFFFFFFFFFFFFFFFFFFFFFFF
FFFFFFFFFFFFFFFFFFFFFFFFFFFFFFFFFFFFFFFFFFFFFFFFFFFFFFFFFFFF