000000004040400000000
022200000000000002220
022200000000000002220
022200000000000002220
000000011000110000000
000000000000000000000
000000000000000000000
110000000000000000011
000222220000022222000
000222225555522222000
000111000000000111000
000000000000000000000
022000000010000000220
022000000000000000220
022000000000000000220
000000000000000000000
111000100090001000111
000000000000000000000
022000000000000000220
022000000000000000220
022000000010000000220
000000000000000000000
000111000000000111000
000222225555522222000
000222220000022222000
110000000000000000011
000000000000000000000
000000000000000000000
000000011000110000000
022200000000000002220
022200000000000002220
022200000000000002220
000000004040400000000