000000004040400000000
000000000000000000000
000000000000000000000
000001110001111100000
000001110002222100000
000000000000000000000
000000000000000000000
000000000222200022000
000000000222200022000
000000000111200022000
000000000000000000000
0000000000000000W0000
000001111000000000000
000002221000000000000
000002221000000000000
000002221000000000000
000002221090122200000
000000000000122200000
000000000000122200000
000000000000122200000
000000000000111100000
0000W0000000000000000
000000000000000000000
000220002111000000000
000220002222000000000
000220002222000000000
000000000000000000000
000000000000000000000
000001222200011100000
000001111100011100000
000000000000000000000
000000000000000000000
000000004040400000000