150000004040400002233
120000000000000002233
120000000000000002333
111000000000000011333
111222000522220111333
555552222555222110001
220012221110022210000
220000021100000000000
330000000000000000022
332200000000000000021
332200000000000111221
332215222000000111221
332215112222211122201
000225555222221000000
000000012200000000000
000000000000000000000
000000000090000000000
000000000000000000000
000000000002210000000
000000122222555522000
102221112222211512233
122111000000222512233
122111000000000002233
120000000000000002233
220000000000000000033
000000000001120000022
000012220011122210022
100011222555222255555
333111022225000222111
333110000000000000111
333500000000000000021
332200000000000000021
332000040404000000021