....TMM..WWWW........
.....MM..WWWW........
.....MM..WWWW..2.2.2.
.........WWWW........
..........WWW........
..........NNN........
..bbbbb...........8..
..b...b...........b..
..b...b.FFF.......b..
..b.YYb.FFFF......b..
..b...b..FFFF..YY.b..
..b...b.MMMFF..YY.b..
..b...b.MMMFFF....b..
..b...b...FFFF....b.F
F.b...b...FFFF....b.F
F.b......FFFF.....b.F
F.b.....FFFFF.....b.F
F.b.....FFFF......b.F
F.b....FFFF...b...b.F
F.b....FFFF...b...b..
..b....FFFMMM.b...b..
..b.YY..FFMMM.b...b..
..b.YY..FFFF..b...b..
..b......FFFF.bYY.b..
..b.......FFF.b...b..
..b...........b...b..
..8...........bbbbb..
........NNN..........
........WWW..........
........WWWW.........
.1.1.1..WWWW..MM.....
........WWWW..MM.....
........WWWW..MMT....