MMM.....2.2.2........
XX...................
FF...................
FF...................
..........8......C...
..........b....YYY...
....XX....b..........
....MM....bbbbbbbbb..
..FFMM............b..
..FF......MMM.....b..
..FF......CC....T.b..
..FF.bbbbbbbbbb.T.b..
XXFF.b........bXX.b..
MMMM.b.NNNN...b...b..
..XX.b.Nbbbbbbb...b..
.....b............b..
..bbbb.........bbbb..
..b............b.....
..b...bbbbbbbN.b.XX..
..b...b...NNNN.b.MMMM
..b.XXb........b.FFXX
..b.T.bbbbbbbbbb.FF..
..b.T....CC......FF..
..b.....MMM......FF..
..b............MMFF..
..bbbbbbbbb....MM....
..........b....XX....
...YYY....b..........
...C......8..........
...................FF
...................FF
...................XX
........1.1.1.....MMM