........2.2.2........
.....................
.....................
.....................
.....................
...............8.....
.....CC....CC..b.....
...............b.YYFF
..FF....FF.....b.YYFF
..CC....CC.....b...FF
...............b.....
..bbbb..bbbb...bbbb..
FFb..b..b..b......b..
FFb..b..b..b......b..
FFb..bbbb..bbbb...b..
..b..NNNYYY.......bCC
CCb......CYC......bCC
CCb.......YYYNNN..b..
..b...bbbb..bbbb..bFF
..b......b..b..b..bFF
..b......b..b..b..bFF
..bbbb...bbbb..bbbb..
.....b...............
FF...b.....CC....CC..
FFYY.b.....FF....FF..
FFYY.b...............
.....b..CC....CC.....
.....8...............
.....................
.....................
.....................
.....................
........1.1.1........