........2.2.2........
.....................
.....................
.....................
.............YYYYY...
...8FFFb.....bbbbb...
...bFFFb.....bFFFb...
...bFFFb..M..bFFFb...
...bFFFb..M..bFFFbMMM
...bFFFb..M..bFFFb...
...bFFFb.....bFFFb...
...bFFFb.....bFFFb...
...bFFFb.....bFFFb...
...bFFFb.....bFFFb...
...bFFFb..YYYbFFFb...
...bFFFbWWWWWbFFFb...
MMMbFFFbWWWWWbFFFbMMM
...bFFFbWWWWWbFFFb...
...bFFFbYYY..bFFFb...
...bFFFb.....bFFFb...
...bFFFb.....bFFFb...
...bFFFb.....bFFFb...
...bFFFb.....bFFFb...
...bFFFb..M..bFFFb...
MMMbFFFb..M..bFFFb...
...bFFFb..M..bFFFb...
...bFFFb.....bFFFb...
...bbbbb.....bFFF8...
...YYYYY.............
.....................
.....................
.....................
........1.1.1........