.....................
........2.2.2........
..............T......
.....................
...N.......T.....TT..
...NFFFF.............
...NFFFF.............
...NMMM.....FFF...8..
............CCC...b..
............MMMM..b..
..bbbbbbbbbbbbbM..b..
..b...........b...b..
YYb...YYY.....b...b..
FFb...........b.T.b..
FFb...bbbbb...b...b..
FFb...b.......b...b..
..b.T.b...C...b.T.b..
..b...b.......b...bFF
..b...b...bbbbb...bFF
..b.T.b...........bFF
..b...b.....YYY...bYY
..b...b...........b..
..b..Mbbbbbbbbbbbbb..
..b..MMMM............
..b...CCC............
..8...FFF.....MMMN...
.............FFFFN...
.............FFFFN...
..TT.....T.......N...
.....................
......T..............
........1.1.1........
.....................