......YMMMM...2.2.2..
.......YMM...........
.......Y.............
.....................
.....................
..bbbbbbbb..MMM...8..
..b......b..MM....b..
..b.FFFF.b........b..
..b.FMMF.b........b..
..b.FMMF.bbbb.CFFFb..
..b.FFFF....b.CFFFb..
..b......NNNb.....b..
..b.........b..bbbb..
..b......bbbb..b.....
..bbbb.MMb.....b.WWWW
.....b...b.....bCWWWW
WWWWCb.........bCWWWW
WWWWCb.....b...b.....
WWWW.b.....bMM.bbbb..
.....b..bbbb......b..
..bbbb..b.........b..
..b.....bNNN......b..
..bFFFC.b....FFFF.b..
..bFFFC.bbbb.FMMF.b..
..b........b.FMMF.b..
..b........b.FFFF.b..
..b....MM..b......b..
..8...MMM..bbbbbbbb..
.....................
.....................
.............Y.......
...........MMY.......
..1.1.1...MMMMY......