........2.2.2........
.....................
.....................
...................FF
....YC.............FF
....NNNN....NNNN...FF
...................FF
..bbbbbbbb.bbbbbb8.FF
..b......b.b.......FF
..b......b.b.MMMM..FF
..b......b.b.YMMM..FF
..b.MMMM.b.b....MY.FF
..b.M....b.b....MY...
..b.M....b.b.........
..b.M....b.b.........
..b...b..b.b..bbbbb..
C.b...b..b.b..b...b.C
..bbbbb..b.b..b...b..
.........b.b....M.b..
.........b.b....M.b..
...YM....b.b....M.b..
FF.YM....b.b.MMMM.b..
FF..MMMY.b.b......b..
FF..MMMM.b.b......b..
FF.......b.b......b..
FF.8bbbbbb.bbbbbbbb..
FF...................
FF...NNNN....NNNN....
FF.............CY....
FF...................
.....................
.....................
........1.1.1........