TT......2.2.2...YYY..
TT..8............CC..
....b................
.bbbb................
.b....CMMWWWMMFF.....
.b..NNNMMWWWMMFF.....
Fb.....T.............
Fb..............MM...
Fb...bbbbbbbbbb.MM...
Fb.YYb........b.FF...
Fb.YYb.WWWWWW.b.FF...
Fb...b.WWWWWW...FF.MM
Fb...b.WWWWWW......MM
Fb...b....NNN........
Fb...b...............
.b...bbbbbbbbbbbbbbb.
.b...CC..YYY..CC...b.
.bbbbbbbbbbbbbbb...b.
...............b...bF
........NNN....b...bF
MM......WWWWWW.b...bF
MM.FF...WWWWWW.b...bF
...FF.b.WWWWWW.bYY.bF
...FF.b........bYY.bF
...MM.bbbbbbbbbb...bF
...MM..............bF
.............T.....bF
.....FFMMWWWMMNNN..b.
.....FFMMWWWMMC....b.
................bbbb.
................b....
..CC............8..TT
..YYY...1.1.1......TT