.2.2.2..FFFFFFF......
........FFFFFFF......
.....................
.........WWWXX...XX..
.........WWW.........
..8......WWW.........
..b...b..WWW..bbbbbb.
..b...bH.WWW..b....b.
..b...b..WWW..b....b.
..b...b..WWW..b....b.
..b...b..WWW..b....b.
..b...bTTWWW..b.CC.b.
..b...bFFF....b....b.
.bbFF.bbb.....b....b.
.b.FF...b.....b....b.
.b.NNNN.b...bbb....b.
.b......b...b......b.
.b....bbb...b.NNNN.b.
.b....b.....b...FF.b.
.b....b.....bbb.FFbb.
.b....b....FFFb...b..
.b.CC.b..WWWTTb...b..
.b....b..WWW..b...b..
.b....b..WWW..b...b..
.b....b..WWWG.b...b..
.b....b..WWW..b...b..
.bbbbbb..WWW..b...b..
.........WWW......8..
.........WWW.........
..XX...XXWWW.........
.....................
......FFFFFFF........
......FFFFFFF..1.1.1.