........2.2.2........
.....................
.....................
FF.................FF
FF........XTFFF....FF
FF........XMMMF....FF
F...................F
F.bbbb8.............F
F.b........bbbbbbbb.F
F.b........b......b.F
F.b.III....b..III.b.F
F.b.IFF....b..FFI.b.F
F.b.IF.bbbbb...FI.b.F
..b....b.....b....b..
..b....b.X...b....b..
..bbbbbb.MM..bbbbbb..
.........III.........
..bbbbbb..MM.bbbbbb..
..b....b...X.b....b..
..b....b.....b....b..
F.b.IF...bbbbb.FI.b.F
F.b.IFF..b....FFI.b.F
F.b.III..b....III.b.F
F.b......b........b.F
F.bbbbbbbb........b.F
F.............8bbbb.F
F...................F
FF....FMMMX........FF
FF....FFFTX........FF
FF.................FF
.....................
.....................
........1.1.1........