........2.2.2........
.....................
.....................
FF...8.............MM
FF...b.........FFFFFM
FF...b.........FFFFF.
FF...b........NNNNFF.
.....b.XX............
.....b.NNNN..........
C....b...............
NNN..bbbbb.bbbbbbbb..
.........b.b..XX..b..
.........b.b.FFF..b..
....FFMM.b.b.FFF..b..
....FFM..b.b.FWW..bXX
..b.FWW..b.b..WW..b..
..b..WW..b.b..WW..b..
..b..WW..b.b..WWF.b..
XXb..WWF.b.b..MFF....
..b..FFF.b.b.MMFF....
..b..FFF.b.b.........
..b..XX..b.b.........
..bbbbbbbb.bbbbb..NNN
...............b....C
..........NNNN.b.....
............XX.b.....
.FFNNNN........b...FF
.FFFFF.........b...FF
MFFFFF.........b...FF
MM.............8...FF
.....................
.....................
........1.1.1........