..TT....2.2.2......CC
...................CC
.....................
FFMMMM....8..........
FF.CMMM...b..MM......
FF........b..MMMM....
FF........b..........
..........b........FF
...bbbbbbbb........MM
...bCCYYWWWW.........
F..bC...WWWW.........
F..bY...FFF.bbbbbb...
F..bWW......b....b...
F..bWW......b..WWb...
F..bWW..bbb.bCCWWb...
C..bY...b...b...Yb...
...bY...b...b...Yb...
...bY...b...b...Yb..C
...bWWCCb.bbb..WWb..F
...bWW..b......WWb..F
...b....b......WWb..F
...bbbbbb.FFF...Yb..F
.........WWWW...Cb..F
.........WWWWYYCCb...
MM........bbbbbbbb...
FF........b..........
..........b........FF
....MMMM..b........FF
......MM..b...MMMC.FF
..........8....MMMMFF
.....................
CC...................
CC......1.1.1....TT..