..............FFFXXXM
...............FFFFTM
....2.2.2...........T
.....................
..............YN.....
....8......NNNNN.....
....b................
....b................
....b.CC.bbbbbb......
....b.CC.b.........YY
FF..b....b.........YY
MMT.b....bbb.........
....b......b.........
....bbbb...bMMMMM....
.......b...b..FFFFF..
MMMM...b...bbbFFFFF..
MTNNNN.b.....b.NNNNTM
..FFFFFbbb...b...MMMM
..FFFFF..b...b.......
....MMMMMb...bbbb....
.........b......b....
.........bbb....b.TMM
YY.........b....b..FF
YY.........b.CC.b....
......bbbbbb.CC.b....
................b....
................b....
.....NNNNN......8....
.....NY..............
.....................
T...........1.1.1....
MTFFFF...............
MXXXFFF..............