........2.2.2........
.....................
.....................
.....................
.....bbbbb8..........
.....b...............
.....b...............
.....b...............
..MM.b.MM..MM...MMM..
..MM.b.MM..MM...MMM..
.....b...............
.bbbbb...bbbbbbbbbbb.
.b.......b.........b.
.b.MMM...b.....MMM.b.
.b.MMM...b.....MMM.b.
.b.............MMM.b.
.b.................b.
.b.MMM.............b.
.b.MMM.....b...MMM.b.
.b.MMM.....b...MMM.b.
.b.........b.......b.
.bbbbbbbbbbb...bbbbb.
...............b.....
..MMM...MM..MM.b.MM..
..MMM...MM..MM.b.MM..
...............b.....
...............b.....
...............b.....
..........8bbbbb.....
.....................
.....................
.....................
........1.1.1........