........2.2.2..FFYY..
...............FFYY..
...............FFFF..
FF...bbbbb8....FFFF..
FF...b.........YYFF..
FF.CCb.YMMMMM..YYFF..
FF.CCb..MMMMM........
.....b...MMM.........
.....bbb..T..........
.......b.....bbbbb...
C......bbb...b...b...
NNN......b.bbb.T.bbb.
.........b.bFFMMM..b.
...FFFMMYb.bFFMMM..b.
...FFMMMYb.bFFMM...b.
.b...WW..b.b..WW...b.
.b...WW..b.b..WW...b.
.b...WW..b.b..WW...b.
.b...MMFFb.bYMMMFF...
.b..MMMFFb.bYMMFFF...
.b..MMMFFb.b.........
.bbb.T.bbb.b......NNN
...b...b...bbb......C
...bbbbb.....b.......
..........T..bbb.....
.........MMM...b.....
........MMMMM..bCC.FF
..FFYY..MMMMMY.bCC.FF
..FFYY.........b...FF
..FFFF....8bbbbb...FF
..FFFF...............
..YYFF...............
..YYFF..1.1.1........