FFFFF................
FFFFF...2.2.2........
FFFFF.........YYYYY..
FFF...............Y..
FFF..8............Y..
FFF..b..L.FFY..b..Y..
FFF..b....FFY..b..Y..
FFFT.b...FFYY..b.....
FFF..b...FFY...b.....
FFF..b...FFY...b.....
FFF..b.........b.....
..T..b.........b.NN..
.....b.........b.N...
.....b..T..CC..b.N...
...T.b.....FF..b.N...
.....b.....FF..b.....
.....b.TFF.FFT.b.....
.....b..FF.....b.....
...N.b..FF.....b.T...
...N.b..CC..T..b.....
...N.b.........b.....
..NN.b.........b..T..
.....b.........b..FFF
.....b...YFF...b..FFF
.....b...YFF...b..FFF
.....b..YYFF...b.TFFF
..Y..b..YFFK...b..FFF
..Y..b..YFF....b..FFF
..Y............8..FFF
..Y...............FFF
..YYYYY.........FFFFF
........1.1.1...FFFFF
................FFFFF