YYC.....2.2.2.....CYY
YC.................CY
.....................
.....................
.....................
.....................
.bbbbbbbbb8..........
.b...................
.b.FFMMMMFFFMMMFFMMMM
.b.FFMMMMFFFMMMFFMMMM
.b...................
.bbbbbbbbbbbbbbbbbbb.
...................b.
aaaaaaFF....FFMMFF.b.
......FF....FFMMFF.b.
...................b.
.bbbbbbbbb.bbbbbbbbb.
.b...................
.b.FFMMFF....FF......
.b.FFMMFF....FFaaaaaa
.b...................
.bbbbbbbbbbbbbbbbbbb.
...................b.
MMMMFFMMMFFFMMMMFF.b.
MMMMFFMMMFFFMMMMFF.b.
...................b.
..........8bbbbbbbbb.
.....................
.....................
.....................
.....................
YC.................CY
YYC.....1.1.1.....CYY