...2.2.2.............
.....................
.....................
.....................
..MM.8...............
..FF.b.MM...FF.......
.....b......MM.......
.....b...........MM..
.....b....bbbbbb.....
..MM.b.FF.b....b.....
.....b.MM.b....b.....
.....b....b.MM.b.FF..
.....b....b....b.MM..
.....b....b....b.....
.....b.........b.....
..MM.b.........b.....
..FF.b...MMM...b.FF..
.....b.........b.MM..
.....b.........b.....
.....b....b....b.....
..MM.b....b....b.....
..FF.b.MM.b....b.....
.....b....b.MM.b.....
.....b....b.FF.b.MM..
.....bbbbbb....b.....
..MM...........b.....
.......MM......b.....
.......FF...MM.b.FF..
...............8.MM..
.....................
.....................
.....................
.............1.1.1...