FFF...............FFF
FFF2.2.2..........FFF
FF.................FF
.....................
.........MM..........
.........MM...MM.....
FFbbbb8.......MM...MM
FFb................MM
FFb..................
FFb....bbbbbbbbbbbb..
F.b....b..........b..
F.b....b.FFF...CC.b..
F.b....b.NNNN..YY.b..
F.b.TT.b.NWW......b..
F.b.TT.b.WWW......b..
C.b....b.WWW.b....b..
..b....b.WWW.b....b..
..b....b.WWW.b....b.C
..b......WWW.b.TT.b.F
..b......WWN.b.TT.b.F
..b.YY..NNNN.b....b.F
..b.CC...FFF.b....b.F
..b..........b....b.F
..bbbbbbbbbbbb....bFF
..................bFF
MM................bFF
MM...MM.......8bbbbFF
.....MM...MM.........
..........MM.........
.....................
FF.................FF
FFF..........1.1.1FFF
FFF...............FFF