......2.2.2..........
.FF.............FFFF.
.FF.............FFFF.
..................FF.
.bbb8.............FF.
.b....CC.....XXX.....
.b...................
.b...................
.b.M...FFWWWFF...MFF.
.b.MMM.FFWWWFF.MMMFF.
.b................FF.
.b................FF.
.b................FF.
.b......bbbbbbb.XXFF.
.b.XXX........b......
.b......M.....b......
.bbbbbb.M...M.bbbbbb.
......b.....M......b.
......b........XXX.b.
.FFXX.bbbbbbb......b.
.FF................b.
.FF................b.
.FF................b.
.FFMMM.FFWWWFF.MMM.b.
.FFM...FFWWWFF...M.b.
...................b.
...................b.
.....XXX.....CC....b.
.FF.............8bbb.
.FF..................
.FFFF.............FF.
.FFFF.............FF.
..........1.1.1......