........2.2.2........
.....................
.....................
.....................
..bbbbbbbbbbbbbbb8...
..b..................
..b.FFFMMM.....MM....
..b.FFF......MMMM....
..b..................
..bbbbbbbbbbbbbbbbb..
..................b..
MMFFF.MMXX..FFFMM.b..
MMFFF.MM....FFFMM.b.F
................X.b.F
..bbbbbbbbbbbbb.X.b.F
..b...............b.F
F.b...............b.F
F.b...............b..
F.b.X.bbbbbbbbbbbbb..
F.b.X................
F.b.MMFFF....MM.FFFMM
..b.MMFFF..XXMM.FFFMM
..b..................
..bbbbbbbbbbbbbbbbb..
..................b..
....MMMM......FFF.b..
....MM.....MMMFFF.b..
..................b..
...8bbbbbbbbbbbbbbb..
.....................
.....................
.....................
........1.1.1........