FFFFF...2.2.2........
FFFFF................
FFFCC................
FFF.............NNN..
FFF..................
FFCC....FF.......8...
F......XMM.......b...
F................b.FF
.................b.FF
...bbbbbbbbbbbb..b.FF
...b.......CC.b..b.MM
FF.b.......XX.b..b...
FF.b.CCY......b..b...
...b.FF..bbbbbb..b...
...b.....b..NNNN.b...
TT.b.....b.....N.b...
...b.............b...
...b.N.....b.....b.TT
...b.NNNN..b.....b...
...b..bbbbbb..FF.b...
...b..b......YCC.b.FF
...b..b.XX.......b.FF
MM.b..b.CC.......b...
FF.b..bbbbbbbbbbbb...
FF.b.................
FF.b................F
...b.......MMX......F
...8.......FF....CCFF
..................FFF
..NNN.............FFF
................CCFFF
................FFFFF
........1.1.1...FFFFF