WWWWWWWWWWWWWWWWWWWWWWWWWWWWWWWWWWWWWWWWWWWWWWWWWWWWWWWWWWWW
WWWWWWWWWWWWWWWWWWWWWWWWWWWWWWWWWWWWWWWWWWWWWWWWWWWWWWWWWWWW
WWWWWWWWWWWWWWWWWWWWWWWWWWWWWWWWWWWWWWWWWWWWWWWWWWWWWWWWWWWW
WWWWWWWWWWWWWWWWWWWWWWWWWWWWWWWWWWWWWWWWWWWWWWWWWWWWWWWWWWWW
WWWWWWWWWWWWWWWWWWWWWWWWWWWWWWWWWWWWWWWWWWWWWWWWWWWWWWWWWWWW
WWWWWWWWWWWWWWWWWWWWWWWWWWWWWWWWWWWWWWWWWWWWWWWWWWWWWWWWWWWW
WWWWWWWWWWWWWWWWWWWWWWWWWWWWWWWWWWWWWWWWWWWWWWWWWWWWWWWWWWWW
WWWWWWWWWWWWWWWWWWWWWWWWWWWWWWWWWWWWWWWWWWWWWWWWWWWWWWWWWWWW
WWWWWWWWWWWWWWWWWÊWWWWWWWWWWWWWWWWWWWWWWWWWWWWWWÊWWWWWWWWWWW
WWWWWWWWWWWWWWWWWWWWWWWWWWWWÊWWWWWWWWWWWWWWWWWWWWWWWWWWWWWWW
WWWWWWWWWWWWWWWWWWWWWWWWWWWWWWWWWWWWWWÊWWWWWWWWWWWWWWWWWWWWW
WWWWWWWWWWWWWWWWWWWWWWWWWWWWWWWWWWWWWWWWWWWWWWWWWWWWWWWWWWWW
WWWWWWWWÊWWWWWWWWWWWWFNNNNWWWWWWWWWWWWWWWWWFFFFWWWWWWWWWWWWW
WWWWWWWWWWWNNNNFFFFÉFFFFFFFFWWWFFFFFWWWWWFFFFÈ.FFWWWWWWWWWWW
WWWWWWWWWWWNFFF.ÈF.É...ÈFFFFFNNN..FFNNNNFFÉ....FFFWWWWWWWWWW
WWWWWWWWWWFFF...FF...F...FFFFF..È.FFFFCYF....FFFFFWWWWWÊWWWW
WWWWWWWWWWFFF...YYCFFFFYCCFFFYCFFFF.....F..CFFFFÈFFWWWWWWWWW
WWWWWWWWWWFFÈ.FEEEEEEEEEEEEEEEEEEEEEEEEEEEEEEF...FFFWWWWWWWW
WWWWWWWWWWFF.FFE...........N.......NFFFFFFFFE..Ë..FFWWWWWWWW
WWWWWWÊWWWWFFFYE...........N.......NFFF3333FE.....TFWWWWWWWW
WWWWWWWWWWWFFFCE..NNNNNN...NNNNN...N..F3333FE....FFFWWWWWWWW
WWWWWWWWWWWF..FE..NT.......N...........3333FECFFYFFNWWWWWWWW
WWWWWWWWWWWF.ÈFE..NY.......N...FFF.....3333FEFFFFFFNWWWWWWWW
WWWWWWWWWWWW.FFE..NNNNNN...N...NNNNNNN...FFFEF..FNNNWWWWWWWW
WWWWWWWWWWWWFFFE.....N.....N........CN....FFEFÈFFWWWWWWWWWWW
WWWWWWWWWWWWFFFE.....N.....NFFF......N...NNNEF..WWWWWWWWWWWW
WWWWWWWÊWWWFFÈFE.....N...NNNNNNNNN...N......EFFTWWWWÊWWWWWWW
WWWWWWWWWWW.FFFE..N......NYCT....N...N......EFFFWWWWWWWWWWWW
WWWWWWWWWWF..FFE..N......N.......N...N...NNNEFFFWWWWWWWWWWWW
WWWWWWWWWFÉ.ÈFFE..NNNNN..N.......N...NFFFNYYEFFFFWWWWWWWWWWW
WWWWWWWWWF...TFE..NC.........2...N...NNNNN..EF.ÈFWWWWWWWWWWW
WWWWWWWWNFFFFFFE.................N.......N..EF..FWWWWWWWWWWW
WWWWWWWWNFF...FE...FFFN........TCYN......N..EFFFFWWWWWWWWWWW
WWWWWWWWNFF.Ë..E...NNNN....NNNNNNNN...N.....EFFFWWWWWWWWWWWW
WWWWWWWWNC.....E......N.........N.....N.....EC..WWWÊWWWWWWWW
WWWWWWWWWY.....ET.....NC........N.....N.....EY.FWWWWWWWWWWWW
WWWWWWWWWWFFF..ENNN...NNNNNNN...N...NNNNNN..EYFFFWWWWWWWWWWW
WWWWWWWWWWWFFT.EYC......N.......N.......CN..E..FFWWWWWWWWWWW
WWWWWWWWWWWFFF.EY.......N.......N.......YN..EF...FFFWWWWWWWW
WWWWWWWWÊWWWFF.E........N...NNNNN...NNNNNN..EF.Ë.FÈ.WWWWWWWW
WWWWWWWWWWWWF..E..1.1..CN...........NC......EF.....FWWWWWWWW
WWWWWWWWWWWWF.FE......CCN...........NC......EF...C.WWWWWWWWW
WWWWWWWWWWWFFFFEEEEEEEEEEEEEEEEEEEEEEEEEEEEEETFFFYWWWWWWWWWW
WWWWWWWWWWWF...FCFFFFFFFFFFFFCY...FFFFFFFFYY....FFWWWWWWWWWW
WWWWWWWWWWWFÈ..É.FFÈFTFF..F.FFFF...FF..È..FFF.È.FWWWWWÊWWWWW
WWWWWWWÊWWWFFFFF......FFF.È.NNNFFFT.È..FFFFFFFFFWWWWWWWWWWWW
WWWWWWWWWWWNNNWWWWFFF.È.F.FFWWWWFFF...F.ÉFWWFFFWWWWWWWWWWWWW
WWWWWWWWWWWWWWWWWWWFFFFFFWWWWWWWWW..FFFFFWWWWWWWWWWWWWWWWWWW
WWWWWWWWWWWWWWÊWWWWWNNNNWWWWWWWWWWWWWWNNNWWWWWWWWWWWWWWWWWWW
WWWWWWWWWWWWWWWWWWWWWWWWWWWWWWÊWWWWWWWWWWWWWWWWWWWWWWWWWWWWW
WWWWWWWWWWWWWWWWWWWWWWWWWWWWWWWWWWWWWWWWWWWWWWWWWWWWWWWWWWWW
WWWWWWWWWWWWWWWWWWWWWÊWWWWWWWWWWWWWWWWWWWWWWWÊWWWWWWWWWWWWWW
WWWWWWWWWWWWWWWWWWWWWWWWWWWWWWWWWWWWWWWWWWWWWWWWWWWWWWWWWWWW
WWWWWWWWWWWWWWWWWWWWWWWWWWWWWWWWWWWWWWWWWWWWWWWWWWWWWWWWWWWW
WWWWWWWWWWWWWWWWWWWWWWWWWWWWWWWWWWWWWWWWWWWWWWWWWWWWWWWWWWWW
WWWWWWWWWWWWWWWWWWWWWWWWWWWWWWWWWWWWWWWWWWWWWWWWWWWWWWWWWWWW
WWWWWWWWWWWWWWWWWWWWWWWWWWWWWWWWWWWWWWWWWWWWWWWWWWWWWWWWWWWW
WWWWWWWWWWWWWWWWWWWWWWWWWWWWWWWWWWWWWWWWWWWWWWWWWWWWWWWWWWWW
WWWWWWWWWWWWWWWWWWWWWWWWWWWWWWWWWWWWWWWWWWWWWWWWWWWWWWWWWWWW
WWWWWWWWWWWWWWWWWWWWWWWWWWWWWWWWWWWWWWWWWWWWWWWWWWWWWWWWWWWW