WWWWWWWWWWWWWWWWWWWWWWWWWWWWWWWWWWWWWWWWWWWWWWWWWWWWWWWWWWWW
WWWWWWWWWWWWWWWWWWWWWWWWWWWWWWWWWWWWWWWWWWWWWWWWWWWWWWWWWWWW
WWWWWWWWWWWWWWWWWWWWWWWWWWWWWWWWWWWWWWWWWWWWWWWWWWWWWWWWWWWW
WWWWWWWWWWWWWWWWWWWWWWWWWWWWWWWWWWWWWWWWWWWWWWWWWWWWWWWWWWWW
WWWWWWWWWWWWWWWWWWWWWWWWWWWWWWWWWWWWWWWWWWWWWWWWWWWWWWWWWWWW
WWWWWWWWWWWWWWWWWWWWWWWWWWWWWWWWWWWWWWWWWWWWWWWWWWWWWWWWWWWW
WWWWWWWWWWWWWWWWWWWWWWWWWWWWWWWWWWWWWWWWWWWWWWWWWWWWWWWWWWWW
WWWWWWWWWWWWWWWWWWWWWWWWWWWWWWWWWWWWWWWWWWWWWWWWWWWWWWWWWWWW
WWWWWWWWWWWWWWWEEEEEEEEEEEEEEEEEEEEEWWWWWWWWWWWWWWWWWWWWWWWW
WWWWWWWWWWWWWWWE...................EWWWWWWWWWWWWWWWWWWWWWWWW
WWWWWWWWWWWWWWWE..........2.2.2....EWWWWWWWWWWWWWWWWWWWWWWWW
WWWWWWWWWWWWWWWE...................EWWWWWWWWWWWWWWWWWWWWWWWW
WWWWWWWWWWWWWWWE....((((((((>......EWWWWWWWWWWWWWWWWWWWWWWWW
WWWWWWWWWWWWWWWE....(....???(.?....EWWWWWWWWWWWWWWWWWWWWWWWW
WWWWWWWWWWWWWWWE....(????...(.?..YCEWWWWWWWWWWWWWWWWWWWWWWWW
WWWWWWWWWWWWWWWE....(?......(.?..IIEEEEEEWWWWWWWWWWWWWWWWWWW
WWWWWWWWWWWWWWWE....(?.II...(.?.FFFFFFFFEWWWWWWWWWWWWWWWWWWW
WWWWWWWWWWWWWWWE....(?.FF...(.?.FFFFFFFFEWWWWWWWWWWWWWWWWWWW
WWWWWWWWWWWWEEEE...?(?.FF...-.?.......FFEWWWWWWWWWWWWWWWWWWW
WWWWWWWWWWWWEFFF...?(..FF....?........FFEWWWWWWWWWWWWWWWWWWW
WWWWWWWWWWWWEFFF...?(..IF....?........FFEWWWWWWWWWWWWWWWWWWW
WWWWWWWWWWWWEFFF...?(..III...?....8...FFEWWWWWWWWWWWWWWWWWWW
WWWWWWWWWWWWEFFXT..?(........?........FFEEEEEWWWWWWWWWWWWWWW
WWWWWWWWWWWWE..XX..?(........?........FFNNNNEWWWWWWWWWWWWWWW
WWWWWWWWWWWWE......?(........?.......FFFFFFFEWWWWWWWWWWWWWWW
WWWWWWWWWWWWE......?-...NNN..?...MMFFFFFFFFFEWWWWWWWWWWWWWWW
WWWWWWWWWWWWE......?.....FF..?...FFFFFFFFFFFEWWWWWWWWWWWWWWW
WWWWWWWWWWWWE......?.....FF..?...FFFF.....FFEWWWWWWWWWWWWWWW
WWWWWWWWWWWWEFFFF........FF......FFF......FFEWWWWWWWWWWWWWWW
WWWWWWWWWWWWEFFFI........FI......XX.......FFEWWWWWWWWWWWWWWW
WWWWWWWWWWWWEFFFI.......III.....III...9...FFEWWWWWWWWWWWWWWW
WWWWWWWWWWWWEFFFI........FI......XX.......FFEWWWWWWWWWWWWWWW
WWWWWWWWWWWWEFFFF........FF......FFF......FFEWWWWWWWWWWWWWWW
WWWWWWWWWWWWE......?.....FF..?...FFFF.....FFEWWWWWWWWWWWWWWW
WWWWWWWWWWWWE......?.....FF..?...FFFFFFFFFFFEWWWWWWWWWWWWWWW
WWWWWWWWWWWWE......?+...NNN..?...MMFFFFFFFFFEWWWWWWWWWWWWWWW
WWWWWWWWWWWWE......?(........?.......FFFFFFFEWWWWWWWWWWWWWWW
WWWWWWWWWWWWE..XX..?(........?........FFNNNNEWWWWWWWWWWWWWWW
WWWWWWWWWWWWEFFXT..?(........?........FFEEEEEWWWWWWWWWWWWWWW
WWWWWWWWWWWWEFFF...?(..III...?....8...FFEWWWWWWWWWWWWWWWWWWW
WWWWWWWWWWWWEFFF...?(..IF....?........FFEWWWWWWWWWWWWWWWWWWW
WWWWWWWWWWWWEFFF...?(..FF....?........FFEWWWWWWWWWWWWWWWWWWW
WWWWWWWWWWWWEEEE...?(?.FF...+.?.......FFEWWWWWWWWWWWWWWWWWWW
WWWWWWWWWWWWWWWE....(?.FF...(.?.FFFFFFFFEWWWWWWWWWWWWWWWWWWW
WWWWWWWWWWWWWWWE....(?.II...(.?.FFFFFFFFEWWWWWWWWWWWWWWWWWWW
WWWWWWWWWWWWWWWE....(?......(.?..IIEEEEEEWWWWWWWWWWWWWWWWWWW
WWWWWWWWWWWWWWWE....(????...(.?..YCEWWWWWWWWWWWWWWWWWWWWWWWW
WWWWWWWWWWWWWWWE....(...???.(......EWWWWWWWWWWWWWWWWWWWWWWWW
WWWWWWWWWWWWWWWE....((((((((<......EWWWWWWWWWWWWWWWWWWWWWWWW
WWWWWWWWWWWWWWWE...................EWWWWWWWWWWWWWWWWWWWWWWWW
WWWWWWWWWWWWWWWE..........1.1.1....EWWWWWWWWWWWWWWWWWWWWWWWW
WWWWWWWWWWWWWWWE...................EWWWWWWWWWWWWWWWWWWWWWWWW
WWWWWWWWWWWWWWWEEEEEEEEEEEEEEEEEEEEEWWWWWWWWWWWWWWWWWWWWWWWW
WWWWWWWWWWWWWWWWWWWWWWWWWWWWWWWWWWWWWWWWWWWWWWWWWWWWWWWWWWWW
WWWWWWWWWWWWWWWWWWWWWWWWWWWWWWWWWWWWWWWWWWWWWWWWWWWWWWWWWWWW
WWWWWWWWWWWWWWWWWWWWWWWWWWWWWWWWWWWWWWWWWWWWWWWWWWWWWWWWWWWW
WWWWWWWWWWWWWWWWWWWWWWWWWWWWWWWWWWWWWWWWWWWWWWWWWWWWWWWWWWWW
WWWWWWWWWWWWWWWWWWWWWWWWWWWWWWWWWWWWWWWWWWWWWWWWWWWWWWWWWWWW
WWWWWWWWWWWWWWWWWWWWWWWWWWWWWWWWWWWWWWWWWWWWWWWWWWWWWWWWWWWW
WWWWWWWWWWWWWWWWWWWWWWWWWWWWWWWWWWWWWWWWWWWWWWWWWWWWWWWWWWWW