_______0404040_______
_______0000000_______
_______0000000_______
_______1100011_______
222220000000000022222
222220000000000022222
000000001000100000000
000000001111100000000
000010007070700010000
000010000000000010000
000110000000000011000
000002222222222200000
220002222222222200022
220002201111102200022
220012200000002210022
220012200000002210022
220012200090002210022
220012200000002210022
220012200000002210022
220002201111102200022
220002222222222200022
000002222222222200000
000110000000000011000
000010000000000010000
000010007070700010000
000000001111100000000
000000001000100000000
222220000000000022222
222220000000000022222
_______1100011_______
_______0000000_______
_______0000000_______
_______0404040_______