_______0404040_______
_______0000000_______
_______0000000_______
_______1100011_______
000022000000000220000
000022000000000220000
000111221111122111000
000001222222222100000
000000000000000000000
200000000000000000000
220000007070700000000
222001111222111100000
000000001222100000002
000000000000000000022
000000000000000000222
000012200000002222222
111112200090002211111
222222200000002210000
222000000000000000000
220000000000000000000
200000001222100000000
000001111222111100222
000000007070700000022
000000000000000000002
000000000000000000000
000001222222222100000
000111221111122111000
000022000000000220000
000022000000000220000
_______1100011_______
_______0000000_______
_______0000000_______
_______0404040_______