MMMMMMMFFFMMMMMMMMMMMMMMMMFFFMMMMMMMFFFMMMMMMMMMMMMMMMMMMMMM
MMMMMMM2F2MMMMMMMMMMMMMMMM2F2MMMMMMM2F2MMMMMMMMMMMMMMMMMMMMM
MMMMMMMF1MMMMMMMMFFFFFFFMMMF1MMMMMMMF1MMMMMMMMMMMMMFFFFFFFMM
MMMMMMMFFMMMFFFFFFFFFFFFMMMFFMMMMMMMFFMMMMMMMMMMMMMFFFFFFFMM
MMMMMMMFFMMMFFFFFFF444FFMMMFFMMMMMMMFFMMMMMMMMMMMMMFFFFFDFMM
MMMMMMMFFMMM..MMMFFFFFFFFFFFFMMFFFMMFFFFFFFFFFFFFFFFF44FFFMM
MMMMMMM..MMM..MMMFDFFFDFFFFFFMMFFFMMFFFFFFFFFFFFFFFFF44FFFMM
MMMMMMM..MMMFFMMMFFFFFFFMMMFFFFFFFFFFFMMMMMMFFMMMMMFFFFFFFMM
MMMMMMMFFFFFFFFFFFFFDFFFMMMFFFFFFFFFFFMMMMMMFFMMMFFFDFFFFFMM
MMMMMFFFFFFFFFFFFFFFFFFFMMMFFF4..F4FFFMMMMMM..MMMFFFFFFFFFMM
MMMMMFFFFFFFFFMMMMMMMMFFFFFFFF...FFFFFMMMMMM..MMMFFFMMFFMMMM
MMMMMMMFFF4FFFMMMMMMMMFFFFFFFFFFFFFFFFFFFFFFFFFFMFFFMMFFMMMM
MMMMMMMFFFFFFFMMMMMMMMFFMMMFFFFFFFFFFFFFFFFFFFFFMFFFMMFFMMMM
MMMMFFFFFFFFFF...FFFFFFFMMMFFMM..MMMMFFMMMMMFFFFFFFFMM..MMMM
MMMMFFFFFFFFFF...FFDFFFFMMM..MM..MMMM..MMMMMFFFDFFFMMM..MMMM
MMMMFFMMMMFFMMMMMFFFFFMMMMM..MMFFMMMM..MMMMMFFFFFFF..FFFMMMM
MMMMFFFFFFFFMMMMMFF4FFFFFFFFFFFFFFFFFFFMMMMMFF4FFFF..FFFMMMM
MMMMFFFFFFFFMMMMMFFFFFFFFFFFFFFFFFFFFDFMMMMMFFFFFFMMMMFFMMMM
MMMMFFMMMMFFFFFFFFFFFFFMMM..MMMMMFFFFFFFFFFFFFFFDFMMMMFFMMMM
MMMM..MMMMFFFFFFFFFFFFFFMM..MMMMMFF4FFFFFFFFFFFFFFMMMMFFMMMM
MMMM..MMMMFFMMMMMFFMMFFFMMFFMMMMMDFFFFFMMMMFFMMMFF..FFFFMMMM
MMMMFFMMMM..MMMMMFFMMFFMMMFFFFFFFFFFFFFMMMMFFMMMFF..FFFFMMMM
MMMMFFMMMM..MMMMMFFMMFFMMMFFFFFFF..FF..MMMM..MMMFFMMMMFFMMMM
MMMMFFMMMMFFMMMMMFFMM..M44..MMMMM..MM..MMMM..MMMFFMMMMFFMMMM
212FFFFFFFFFFFFFFFFMM..M.....CC.....M..MMMMFFMMMFFMMMMFFMMMM
FFFFFFFFFFFFFDFFFFFMM..M............M..MFFFFFFFFFFFFFFFFFFFF
MMMMMMMMFFFFFFFFMMMMM..M............M..MFFFFFFFFFFFFFFFFF212
MMMMMMMMFFFFFFDFFF......................FFMMMMMMFFMMMFFMMMMM
MMMMMMMMFFF4FFFFFF......................FFMMMMMMFFMMMFFMMMMM
MMMMMMMMFFFFFFFFMMM..MMMC....WWW....MMMFFFFFFFFFFFMMM..MMMMM
MMMMMMMMFFFFFFFFMMM..MMMC....WWW....4MMFFFFFFFFFFFMMM..MMMMM
MMMMMFFFFFFDFFFFMMM..........WWW....4MMFFF4MMMMMFFMMMFFMMMMM
MMMMMFFFFFFFFFFFMMM................CMMMFFFFMMMMMFFFFFFF...MM
MMMMMFFFFFMMFFMMMMM..MMM...........CMMMFFFFMMMMMFDFFFDF...MM
MMMMMMMMFFMMFFMMMMMFFMMM.................FMMMMMMFFFFFFF...MM
MMMMMMMMFFMMFFMMMMMFFMM4......CC.........FFFF...FFF4FFFMMMMM
MMMMMMMM..MMFFFFFFFFFMM4......MM44MMMMMMFFFFF...FFFFFFFMMMMM
MMMMMMMM..MMFFFFFFFFFMMMMMMM..MMMMMMMMMMFFMMMMMMFFFFFFFMMMMM
MMMMMMMM..MMMMFFMMMFFMMMMMMMFFMMMMMMMMMMFFMMMMMMFFFDFFFMMMMM
.1.FFFFFFFDFFFFFMMMFFFFFFFFFFFMMMFFFFFFFFFFFFFFFFFFFFFFFFFFF
FFFFFFFFFFFFFFFFMMMFFFFFFFFFFFMMMFDFFFFFFFFFFFFFFFFFFFFFF.1.
MMMMMFFMMFFF4FFFMMMMMFFMMMMMFFFFFFFFF4FFFFMMMFFMMMMFFMMMMMMM
MMMMMFFMMFFFFFFFMMMMMFFMMMMMFFFFFFFFFFFFFFMMMFFMMMM..MMMMMMM
MMMMMFFMMFFFDFFFMMMM4FFMMMMM..MMMFFFFFFFDFMMM..MMMM..MMMMMMM
MMFFMFFMMFFFFFFFMMMM...MMMMM..MMMMMFFMMMMMMMM..MMMMFFMMMMMMM
MMFFMFFMMMMMMMFFMMMM...MMMMMFFMMMMMFFMMMMMMMMFFMMMMFFFFFFMMM
MFFFFFFMMMMMMMFFMMMMMFFFFFFFFFFFMMM..MMFFFFFFFFFFFFFFFFFFMMM
MFFFFFFMMMMMMMFFMMMMMFFDFFFFFFFFMMM..MMFFFFFFFFFFFFFFMMFFMMM
MFFMM..MMMMMMMFFFFFFFFFFFF4FFFFFFFFFFFFFFDF4FFFMMMMMMMMFFMMM
MFFMM..MMMMMMMFFFFFFFFFFFFFFFDFFFFFFFFFFFFFFFFFMMMMMMMMFFMMM
MFFMMFFMMMMMMM..MFFMMFFFDFFFFFFFMFFMMMMFFFFFFDFFFFFFFFFFFFMM
MFFFFFFFFFFFFF..MFFMMFFFFFFFFFFFMFFMMMMFFFFFFFFFFFFFFFFFF4MM
MFFFFFFFFFFFFF..MFFMMFFMMMFFMMMMMFFFFFFFFMMMMFFMMMFFMMMF44MM
M444MMMMFFMMMMMMMFFFFFFMMMFFMMMMMFFFFFFFFMMMMFFMMMFFMMMFFMMM
MMMMMMMMFFMMMMMMMFFFFFFMMMFFF...FFFMMMMFFF..FFFMMMFFMMMFFMMM
MMMMMMMMFFFFF..FFFFMMFF...FFF...FFFMMMM.F...FFFMMMFF..FFFMMM
MMMMMMMM...FF..FFFFMMFF...F.MMMMMMMMMMMFFMMMMFFMMMFF..FFFMMM
MMMMMMMMFFMMMMMMMMMMMMMMMMFFMMMMMMMMMMMFFMMMMFFFFFFFMMMMMMMM
MMMMMMMM1FMMMMMMMMMMMMMMMM1FMMMMMMMMMMM1FMMMMFFFFFFFMMMMMMMM
MMMMMMMMFFMMMMMMMMMMMMMMMMFFMMMMMMMMMMMFFMMMMMMMMMMMMMMMMMMM