WWWWWWWWWWWWWWWWWWWWWWWWWWWWWWWWWWWWWWWWWWWWWWWWWWWWWWWWWWWW
WWWWWWWWWWWWWWWWWWWWWWWWWWWWWWWWWWWWWWWWWWWWWWWWWWWWWWWWWWWW
WWWWWWWWWWWWWWWWWWWWWWWWWWWWWWWWWWWWWWWWWWWWWWWWWWWWWWWWWWWW
WWWWWWWWWWWWWWWWWWWWWWWWWWWWWWWWWWWWWWWWWWWWWWWWWWWWWWWWWWWW
WWWWWWWWWWWWWWWWWWWWWWWWWWWWWWWWWWWWWWWWWWWWWWWWWWWWWWWWWWWW
WWWWWWWWWWWWWWWWWWWWWWWWWWWWWWWWWWWWWWWWWWWWWWWWWWWWWWWWWWWW
WWWWWWWWWWWWWWWWWWWWWWWWWWWWWWWWWWWWWWWWWWWWWWWWWWWWWWWWWWWW
WWWWWWWWWWWWWWWWWWWWWWWWWWWWWWWWWWWWWWWWWWWWWWWWWWWWWWWWWWWW
WWWWWWWWWWWWWWWWWWWWWWWWWWWWWWWWWWWWWWWWWWWWWWWWWWWWWWWWWWWW
WWWWWWWWWWWWWWWWWWWWWWWWWWWWWWWWWWWWWWWWWWWWWWWWWWWWWWWWWWWW
WWWWWWWWWWWWWWW..............................WWWWWWWWWWWWWWW
WWWWWWWWWWWWWWW..............................WWWWWWWWWWWWWWW
WWWWWWWWWWWWWWW..............................WWWWWWWWWWWWWWW
WWWWWWWWWWWWWWW..............................WWWWWWWWWWWWWWW
WWWWWWWWWWWWWWW....NNNNNNNNNNNNNNNNNNNNNN....WWWWWWWWWWWWWWW
WWWWWWWWWWWWWWW....N....................N....WWWWWWWWWWWWWWW
WWWWWWWWWWWWWWW....N.bbbbbbbbbbbbbbbbbb.N....WWWWWWWWWWWWWWW
WWWWWWWWWWWWWWW....N.b................b.N....WWWWWWWWWWWWWWW
WWWWWWWWWWWWWWW....N.b................b.N....WWWWWWWWWWWWWWW
WWWWWWWWWWWWWWW....N.bbbbbbbbbbbbbbbbbb.N....WWWWWWWWWWWWWWW
WWWWWWWWWWWWWWW....N....................N....WWWWWWWWWWWWWWW
WWWWWWWWWWWWWWW....N.1........1.......1.N....WWWWWWWWWWWWWWW
WWWWWWWWWWWWWWW....N..MM....XX....TT....N....WWWWWWWWWWWWWWW
WWWWWWWWWWWWWWW....N..MMMM..XXXX..TTTT..N....WWWWWWWWWWWWWWW
WWWWWWWWWWWWWWW....N....................N....WWWWWWWWWWWWWWW
WWWWWWWWWWWWWWW....N....................N....WWWWWWWWWWWWWWW
WWWWWWWWWWWWWWW....N....................N....WWWWWWWWWWWWWWW
WWWWWWWWWWWWWWW....N..YY....CC....BB....N....WWWWWWWWWWWWWWW
WWWWWWWWWWWWWWW....N..YYYY..CCCC..BBBB..N....WWWWWWWWWWWWWWW
WWWWWWWWWWWWWWW....N....................N....WWWWWWWWWWWWWWW
WWWWWWWWWWWWWWW....N.1.......1..........N....WWWWWWWWWWWWWWW
WWWWWWWWWWWWWWW....N..NNNNNN....aaaaa...N....WWWWWWWWWWWWWWW
WWWWWWWWWWWWWWW....N..N....N....a...a...N....WWWWWWWWWWWWWWW
WWWWWWWWWWWWWWW....N..N....NNN..a...a...N....WWWWWWWWWWWWWWW
WWWWWWWWWWWWWWW....N..NNN....N..a...a...N....WWWWWWWWWWWWWWW
WWWWWWWWWWWWWWW....N....N....N..a...a...N....WWWWWWWWWWWWWWW
WWWWWWWWWWWWWWW....N....NNNNNN..aaaaa..1N....WWWWWWWWWWWWWWW
WWWWWWWWWWWWWWW....N...........1........N....WWWWWWWWWWWWWWW
WWWWWWWWWWWWWWW....N............DD......N....WWWWWWWWWWWWWWW
WWWWWWWWWWWWWWW....N..FFF..FFF..DD.WWW..N....WWWWWWWWWWWWWWW
WWWWWWWWWWWWWWW....N..FFF.......DD.WWW..N....WWWWWWWWWWWWWWW
WWWWWWWWWWWWWWW....N..FFF..FFF.....WWW..N....WWWWWWWWWWWWWWW
WWWWWWWWWWWWWWW....N.1........1.......1.N....WWWWWWWWWWWWWWW
WWWWWWWWWWWWWWW....N....................N....WWWWWWWWWWWWWWW
WWWWWWWWWWWWWWW....NNNNNNNNNNNNNNNNNNNNNN....WWWWWWWWWWWWWWW
WWWWWWWWWWWWWWW..............................WWWWWWWWWWWWWWW
WWWWWWWWWWWWWWW..............................WWWWWWWWWWWWWWW
WWWWWWWWWWWWWWW..............................WWWWWWWWWWWWWWW
WWWWWWWWWWWWWWW..............................WWWWWWWWWWWWWWW
WWWWWWWWWWWWWWWWWWWWWWWWWWWWWWWWWWWWWWWWWWWWWWWWWWWWWWWWWWWW
WWWWWWWWWWWWWWWWWWWWWWWWWWWWWWWWWWWWWWWWWWWWWWWWWWWWWWWWWWWW
WWWWWWWWWWWWWWWWWWWWWWWWWWWWWWWWWWWWWWWWWWWWWWWWWWWWWWWWWWWW
WWWWWWWWWWWWWWWWWWWWWWWWWWWWWWWWWWWWWWWWWWWWWWWWWWWWWWWWWWWW
WWWWWWWWWWWWWWWWWWWWWWWWWWWWWWWWWWWWWWWWWWWWWWWWWWWWWWWWWWWW
WWWWWWWWWWWWWWWWWWWWWWWWWWWWWWWWWWWWWWWWWWWWWWWWWWWWWWWWWWWW
WWWWWWWWWWWWWWWWWWWWWWWWWWWWWWWWWWWWWWWWWWWWWWWWWWWWWWWWWWWW
WWWWWWWWWWWWWWWWWWWWWWWWWWWWWWWWWWWWWWWWWWWWWWWWWWWWWWWWWWWW
WWWWWWWWWWWWWWWWWWWWWWWWWWWWWWWWWWWWWWWWWWWWWWWWWWWWWWWWWWWW
WWWWWWWWWWWWWWWWWWWWWWWWWWWWWWWWWWWWWWWWWWWWWWWWWWWWWWWWWWWW
WWWWWWWWWWWWWWWWWWWWWWWWWWWWWWWWWWWWWWWWWWWWWWWWWWWWWWWWWWWW