WWWWWWWWWWWWWWWWWWWWWWWWWWWWWWWWWWWWWWWWWWWWWWWWWWWWWWWWWWWW
WWWWWWWWWWWWWWWWWWWWWWWWWWWWWWWWWWWWWWWWWWWWWWWWWWWWWWWWWWWW
WWWWWWWWWWWWWWWWWWWWWWWWWWWWWWWWWWWWWWWWWWWWWWWWWWWWWWWWWWWW
WWWWWWWWWWWWWWWWWWWWWWWWWWWWWWWWWWWWWWWWWWWWWWWWWWWWWWWWWWWW
WWWWWWWWWWWWWWWWWWWWWWWWWWWWWWWWWWWWWWWWWWWWWWWWWWWWWWWWWWWW
WWWWWWWWWWWWWWWWWWWWWWWWWWWWWWWWWWWWWWWWWWWWWWWWWWWWWWWWWWWW
WWWWWWWWWWWWWWWWWWWWWWWWWWWWWW WWWWWWWWWWWWWWWWWWWWWWWWWWWWW
WWWWWWWWWWWWWWWWWWWW WWWWWWWWWWWWWWWWWWWWWWWWWWWWWWWWWWWWWWW
WWWWWWWWWWWWWWWWWWWWWWWWWWWWWWWWWWWWWWWWW WWWWWWWWWWWWWWWWWW
WWWWWWWWWWWWWWWWWWWWWWWWWWWWWWWWWWWWWWWWWWWWWWWWWWWWWWWWWWWW
WWWWWWWWWWWWWWWWWWWWWWWWWWWWWWWWW WWWWWWWWWWWWWWWWWWWWWWWWWW
WWWWWWWWWWWWWWW WWWWWWWW WWWWWWWWWWWWWWWWWWWWWWWWWWWWWWWWWWW
WWWWWWWWWWWWWWWWWWWWWWWWWWWWWWWWWWWWWWWWWWWW WWWWWWWWWWWWWWW
WWWWWWWWWWWWWWWWWWWWWWWWWWWWWWWWWWWWWWWWWWWWWWWWWWWWWWWWWWWW
WWWWWWWWWWWWWWWWWWWEEEEEEEEEEEEEEEEEEEEEEWWWWWWWWWWWWWWWWWWW
WWWWWWWWWWWWWWWWWWWE....................EWWWWWWWWWWWWWWWWWWW
WWWWWWWWWWWWWWWWWWWE.bbbbbbbbbbbbbbbbbb.EWWWWWWWWWWWWWWWWWWW
WWWWWWWWWWWWWWWWWWWE.b................b.EWWWWWWWWWWWWWWWWWWW
WWWWWWWWWWWWWWWWWWWE.bWWW.............b.EWWWWWWWWWWWWWWWWWWW
WWWWWWWWWWWWWWWWWWWE.bbbbbbbbbbbbbbbbbb.EWWWWWWWWWWWWWWWWWWW
WWWWWWWWWWWWWWWWWWWE....................EWWWWWWWWWWWWWWWWWWW
WWWWWWWWWWWWWWWWWWWE.1........1.......1.EWWWWWWWWWWWWWWWWWWW
WWWWWWWWWW.........E..MM....XX....TT....E.......WWWWWWWWWWWW
WWWWWWWWWW.........E..MMMM..XXXX..TTTT..E.......WWWWWWWWWWWW
WWWWWWWWWW.........E....................E.......WWWWWWWWWWWW
WWWWWWWWWW....À..À.E....................E.À.....WWWWWWWWWWWW
WWWWWWWWWW.........E....................E.......WWWWWWWWWWWW
WWWWWWWWWW.........E..YY....CC....BB....E.......WWWWWWWWWWWW
WWWWWWWWWW....À..À.E..YYYY..CCCC..BBBB..E....À..WWWWWWWWWWWW
WWWWWWWWWW.........E....................E.......WWWWWWWWWWWW
WWWWWWWWWW.........E.1.......1..........E.......WWWWWWWWWWWW
WWWWWWWWWW.........E..NNNNNN....aaaaa...E.......WWWWWWWWWWWW
WWWWWWWWWW.........E..N....N....a...a...E.…..…..WWWWWWWWWWWW
WWWWWWWWWW....…..….E..N....NNN..a...a...E.......WWWWWWWWWWWW
WWWWWWWWWW.........E..NNN....N..a...a...E.......WWWWWWWWWWWW
WWWWWWWWWW....…..….E....N....N..a...a...E.…..…..WWWWWWWWWWWW
WWWWWWWWWW.........E....NNNNNN..aaaaa..1E.......WWWWWWWWWWWW
WWWWWWWWWW.........E...........1........E.......WWWWWWWWWWWW
WWWWWWWWWW.........E............DD......E.......WWWWWWWWWWWW
WWWWWWWWWW.........E..FFF..FFF..DD.WWW..E.»..»..WWWWWWWWWWWW
WWWWWWWWWW.....»»..E..FFF.......DD.WWW..E.......WWWWWWWWWWWW
WWWWWWWWWW.....»»..E..FFF..FFF.....WWW..E.......WWWWWWWWWWWW
WWWWWWWWWW.........E.1........1.......1.E.»..»..WWWWWWWWWWWW
WWWWWWWWWW.........E....................E.......WWWWWWWWWWWW
WWWWWWWWWW.........EEEEEEEEEEEEEEEEEEEEEE.......WWWWWWWWWWWW
WWWWWWWWWWWWWWWWWWWWWWWWWWWWWWWWWWWWWWWWWWWWWWWWWWWWWWWWWWWW
WWWWWWWWWWWWWWWWWWWWWWWWWWWWWWWWWWWWWWWWWWWWWWWWWWWWWWWWWWWW
WWWWWWWWWWWWWWWWWWWWWW WWWWWWWW WWWWWWWWWWWWWWWWWWWWWWWWWWWW
WWWWWWWWWWWWWWWWWWWWWWWWWWWWWWWWWWWWWWWWWW WWWWWWWWWWWWWWWWW
WWWWWWWWWWWWWWWW WWWWWWWWWWWWWWWWWWWWWWWWWWWWWWWWWWWWWWWWWWW
WWWWWWWWWWWWWWWWWWWWWWWWWWWWWWWWWWWWWWWWWWWWWWWWWWWWWWWWWWWW
WWWWWWWWWWWWWWWWWWWWWWWWWW WWWWWWWWW WWWWWWWWWWWWWWWWWWWWWWW
WWWWWWWWWWWWWWWWWWWWWWWWWWWWWWWWWWWWWWWWWWWWWWWWWWWWWWWWWWWW
WWWWWWWWWWWWWWWWWWWWWWWWWWWWWWWWWWWWWWWWWWWWWWWWWWWWWWWWWWWW
WWWWWWWWWWWWWWWWWWWWWWWWWWWWWWWWWWWWWWWWWWWWWWWWWWWWWWWWWWWW
WWWWWWWWWWWWWWWWWWWWWWWWWWWWWWWWWWWWWWWWWWWWWWWWWWWWWWWWWWWW
WWWWWWWWWWWWWWWWWWWWWWWWWWWWWWWWWWWWWWWWWWWWWWWWWWWWWWWWWWWW
WWWWWWWWWWWWWWWWWWWWWWWWWWWWWWWWWWWWWWWWWWWWWWWWWWWWWWWWWWWW
WWWWWWWWWWWWWWWWWWWWWWWWWWWWWWWWWWWWWWWWWWWWWWWWWWWWWWWWWWWW
WWWWWWWWWWWWWWWWWWWWWWWWWWWWWWWWWWWWWWWWWWWWWWWWWWWWWWWWWWWW