M.D.......D...D...D.M
M...D..D............M
MM.....M..2..M..D..MM
MMM.D.MMM...MMM...MMM
MMFFFFFMFFFFFMFFFFFMM
BBFFFFFBFFFFFBFFFFFBB
BBFFFFFBFFFFFBFFFFFBB
BBFFFFFBFFFFFBFFFFFBB
MMFFFFFMFFFFFMFFFFFMM
MMMBBBMMMBBBMMMBBBMMM
MMFFFFFMFFFFFMFFFFFMM
..FFFFFBFFFFFBFFFFF..
..FFFFFBFFFFFBFFFFF..
B.FFFFFBFFFFFBFFFFF.B
BBFFFFFMFFFFFMFFFFFBB
BBBBBBMMMBBBMMMBBBBBB
BBFFFFFMFFFFFMFFFFFBB
B.FFFFFBFFFFFBFFFFF.B
..FFFFFBFFFFFBFFFFF..
..FFFFFBFFFFFBFFFFF..
MMFFFFFMFFFFFMFFFFFMM
MMMBBBMMMBBBMMMBBBMMM
MMFFFFFMFFFFFMFFFFFMM
BBFFFFFBFFFFFBFFFFFBB
BBFFFFFBFFFFFBFFFFFBB
BBFFFFFBFFFFFBFFFFFBB
MMFFFFFMFFFFFMFFFFFMM
MMM...MMM...MMM...MMM
MM...D.M.D...M...D.MM
MMD............D...MM
MM..D.....D..D...D.MM
MBB....D..........BBM
MBBB..1.1.1.1.1..BBBM