333000004040400000011
333000000000000000001
333000000000000000000
333000000000000000000
333000000000000000000
000000002222200000333
333000002222200000000
333000005555500000000
333000000000000000111
000000000000000000000
000000522222221000000
000000522222221000000
001000555222111000100
001000000000000000100
111000000000000000111
333000000000000000333
333000000090000000333
333000000000000000333
111000000000000000111
001000000000000000100
001000111222555000100
000000122222225000000
000000122222225000000
000000000000000000000
111000000000000000333
000000005555500000333
000000002222200000333
000000002222200000333
000000000000000000333
000000000000000000333
000000000000000000333
100000000000000000333
110000004040400000333