222222221112122222222
2HHHHHHHHHHHHHHHHHHHH
2HHHHHHHHHHHHHHHHHHHH
22HHHHHHHHHHHHHHHHHHH
22HHHHHHHHHHHHHGHHHHH
221HHHHHHHHHHHHHHHHHH
222HHHHHHHHHHHHHHHHHH
222HHHHHHHHHHHHHHHHHH
222HHHHHHH11HHHHH11H1
222HGHHHHHGGHHHHHGGG1
22HHHHHHHHHHHHHHHHHH1
22HHHHHHHHHHHHHHHHHHH
22HHHHHHHHHHHHHHHHHHH
21HHHHGGH3333HHH22HHH
2HHHHHHH333333HH11HHH
2HHHHHHH333333HHHHHHH
2HHHHHHH333333HHHHHHH
2HHH21HH333333HHHHHHH
2HH121GGH3333HHHHHHH2
2HHHHHHHHHHHH221HHHH2
2HHHHHHHHHHHHHHHHHHH2
2HHHHHHHHHHHHHHHHHHH2
2HH1HHHHHH11HHHHHHH22
2G11HHHHHH11HHHHGHH22
2HHHHHHHHHHHHHHHHHH22
2HHHHHHHHHHHHHHHHHH22
2HHHHHHHHHHHHHHHHHHH2
2HHHHHHHHHHHHHHHHHHH2
2HHHHHHHHHHHHHHHHHHH2
2HHHHHHHHHHHHHHHHHHHH
2HHHHHHH33434HHHHHHHH
