000000001010100000000
000000000000000000000
200000000000000000000
200011000000001110000
200011100000000110000
220000000000000000000
220000000000000000000
220000000000000000000
220110000222000002211
220110000111000001111
200000000000000000001
200000000000000000000
200001220000000000000
200001110000011122100
000000000000011122100
000000000000000000000
000000000090000000000
000000000000000000000
001221110000000000000
001221110000011100002
000000000000022100002
000000000000000000002
100000000000000000002
111100000111000011022
112200000222000011022
000000000000000000022
000000000000000000022
000000000000000000022
000011000000001110002
000011100000000110002
000000000000000000002
000000000000000000000
000000001010100000000