000000002222220000022
040404002222220000022
000000002211111001122
000000033333000000002
000000033333000000002
000000033310000000000
000000033310000000000
110000111110000550000
110002222200000950000
000002222200000000000
220000001100000000000
220000000000000000011
222000000000011000011
122200000000000000000
112201111000000000022
122200000000000000022
222000000000000000222
220000000000000002221
220000000000111102211
000000000000000002221
110000110000000000222
110000000000000000022
000000000001100000022
000000000002222200000
000059000002222200011
000055000011111000011
000000000013330000000
000000000013330000000
200000000333330000000
200000000333330000000
221100111112200000000
220000022222200404040
220000022222200000000