100000004040400000001
000000000000000000000
000000000000000000000
000000000000000000000
000000000000000000000
000011000000000110000
000111100000001111000
000111100000001111W00
222222222222222222W00
222222222222222222W00
222222000000000000000
222220000000000000000
222213300000001100000
222213300000001000000
221113300000000000000
003333300000000000000
003333300090003333300
000000000000003333300
000000000000003311122
000000100000003312222
000001100000003312222
000000000000000022222
000000000000000222222
00W222222222222222222
00W222222222222222222
00W111100000001111000
000111100000001111000
000011000000000110000
000000000000000000000
000000000000000000000
000000000000000000000
000000000000000000000
100000004040400000001