xxxxxM..........TFFFF
xy.xxM..........TFFFF
x..xxM..NNNNN...TFFFF
xxxxx................
MMMxx................
............CCC...YYY
.....................
.......2..2..2.......
...MMM.........TTT...
........NNNN...FFF...
...............FFF...
..............NFFFMMM
.....N..FTTTF.NFFF...
MMM..N..FWWWF.N......
.....N..TWWWF........
..FF....TWWWF....TT..
..FF....TWWWT....FF..
..TT....FWWWT....FF..
........FWWWT..N.....
......N.FWWWF..N..MMM
...FFFN.FTTTF..N.....
MMMFFFN..............
...FFF...............
...FFF...NNNN........
...TTT.........MMM...
.......1..1..1.......
.....................
YYY...CCC............
................xxMMM
................xxxxx
FFFFT...NNNNN..Mxxy.x
FFFFT..........Mxx..x
FFFFT..........Mxxxxx