WWFFFWWW2.2.2......CC
WWFFFWWW............C
WWFFFWWW.............
WWFFFWWWT............
WWFFFWWWWWW..WWWWWW..
WWFFFWWWWWW..WWWWWW..
WWFFFWWWWWW..WWWWWW..
WWFF.........FFFFFF..
WWF..........FFFFFF..
WWF..NNNNNN..MMMMMM..
WWF..WWWWWW..WWWWWW..
WWF..WWWWWW..WWWWWW..
WWF..WWWWWW..WWWWWW..
FFF..WWWWWF..WWWFF...
FFF..WWWFFF..WWWF....
FF...WWWF....WWW....F
F....WWW.....WWW....F
F....WWW....FWWW...FF
....FWWW..FFFWWW..FFF
...FFWWW..FWWWWW..FFF
..WWWWWW..WWWWWW..FWW
..WWWWWW..WWWWWW..FWW
..WWWWWW..WWWWWW..FWW
..MMMMMM..NNNNNN..FWW
..FFFFFF..........FWW
..FFFFFF.........FFWW
..WWWWWW..WWWWWWFFFWW
..WWWWWW..WWWWWWFFFWW
..WWWWWW..WWWWWWFFFWW
............TWWWFFFWW
.............WWWFFFWW
C............WWWFFFWW
CC......1.1.1WWWFFFWW