MMMFFF..2.2.2..FFFMMM
MMMFFF.........FFFMMM
MMMFFFMMM...MMMFFFMMM
FFFFFFFFFFFFFFFFFFFFF
FFFFFFFFFFFFFFFFFFFFF
FFFFFFFFFFFFFFFFFFFFF
MMMFFFMMMFFFMMMFFFMMM
MMMFFFMMMFFFMMMFFFMMM
MMMFFFMMMFFFMMMFFFMMM
FFFFFFFFFFFFFFFFFFFFF
FFFFFFFFFFFFFFFFFFFFF
FFFFFFFFFFFFFFFFFFFFF
MMMFFFMMMWWWMMMFFFMMM
MMMFFFMWWWWWWWMFFFMMM
MMMFFFMWWWWWWWMFFFMMM
FFFFFFWWWWWWWWWFFFFFF
FFFFFFWWWWWWWWWFFFFFF
FFFFFFWWWWWWWWWFFFFFF
MMMFFFMWWWWWWWMFFFMMM
MMMFFFMWWWWWWWMFFFMMM
MMMFFFMMMWWWMMMFFFMMM
FFFFFFFFFFFFFFFFFFFFF
FFFFFFFFFFFFFFFFFFFFF
FFFFFFFFFFFFFFFFFFFFF
MMMFFFMMMFFFMMMFFFMMM
MMMFFFMMMFFFMMMFFFMMM
MMMFFFMMMFFFMMMFFFMMM
FFFFFFFFFFFFFFFFFFFFF
FFFFFFFFFFFFFFFFFFFFF
FFFFFFFFFFFFFFFFFFFFF
MMMFFFMMM...MMMFFFMMM
MMMFFF.........FFFMMM
MMMFFF..1.1.1..FFFMMM