MM......2.2.2........
MM...................
MMY........FFFFFFFFFF
MMYYY......WWWWYYFFFF
MNNNN......WWWWWCF...
MNFFF........WWW.....
MC...................
.....................
...............WW....
FF.............WW....
MC............WWW....
MN...........TWWWF...
MNNN........WWWWWFFFF
MMYYF.......WWWWTFFFF
MMYFFFFCY...FFFFFFFFF
MMFFFFFYY...FFFFFFFFF
MMFFFFFFF...FFFFFFFMM
FFFFFFFFF...YYFFFFFMM
FFFFFFFFF...YCFFFFYMM
FFFFTWWWW.......FYYMM
FFFFWWWWW........NNNM
...FWWWT...........NM
....WWW............CM
....WW.............FF
....WW...............
.....................
...................CM
.....WWW........FFFNM
...FCWWWWW......NNNNM
FFFFYYWWWW......YYYMM
FFFFFFFFFF........YMM
...................MM
........1.1.1......MM