.....................
.............FF......
...TT....f...FFTT....
..FFWWW......WWW.....
..FFWWW..CC..WWW.....
....WWW......WWW.....
........FFFF.....2...
.....FFFFFFFFFF...2..
.....MMFFFFFFMMM...2.
......MFF...MM.......
....P.M.....MM.......
.FMM..M..............
.FMMMMM..........MM..
.FFF.............MMF.
FFFF...........MMMFF.
FFF...............FFF
FFF...............FFF
FFF...............FFF
.FFMMM...........FFFF
.FMM.............FFF.
..MM..........MMMMMF.
..............MZ.MMF.
.......MM.....M......
.......MM...FFM......
.1...MMMFFFFFFMM.....
..1...FFFFFFFFFF.....
...1.....FFFF........
.....WWW......WWW....
.....WWW..CC..WWWFF..
.....WWW..f...WWWFF..
....TTFF........TT...
......FF.............
.....................