.........WWN..2.2.2..
.........WWN.........
.........WWN.........
.........NNN.........
.....................
.....................
..........FF...YYC...
NNNNN.....FF.........
WWXFFFFFFFFF.........
WWFFFFFFFFFC.........
WWFF.................
WWFF..........FF.....
......YY...NNNFF.....
......C.....FFFF.....
............FFFFX....
..............NNN....
.....................
....NNN..............
....XFFFF............
.....FFFF.....C......
.....FFNNN...YY......
.....FF..........FFWW
.................FFWW
.........CFFFFFFFFFWW
.........FFFFFFFFFXWW
.........FF.....NNNNN
...CYY...FF..........
.....................
.....................
.........NNN.........
.........NWW.........
.........NWW.........
..1.1.1..NWW.........