........FFFMMMMMMMMMM
..........FFFXXMMMXXM
...2.2.........MMMXXM
.......MMM........XXM
...2...NNNNN...e..XXM
.......FFFFFFF......M
...XXFFFFFFFFF......M
...XXFFFF...FFFXXFFFM
.....FFMM...FFFXXFFFM
.......MMMMFFF....FF.
.......MMMMFFF....FF.
..y.......FFF....FFF.
..........FFF....FFF.
............NNNNNFF..
............MMMFFFF..
MMM............FFFFMM
MMM...............MMM
MMFFFF............MMM
..FFFFMMM............
..FFNNNNN............
.FFF....FFF......y...
.FFF....FFF..........
.FF....FFFMMMM.......
.FF....FFFMMMM.......
MFFFXXFFF...MMFF.....
MFFFXXFFF...FFFFXX...
M......FFFFFFFFFXX...
M...e..FFFFFFF.......
MXX......NNNNN...1...
MXX........MMM.......
MXXMMM.........1.1...
MXXMMMXXFFF..........
MMMMMMMMMMFFF........