MMM..............FFFF
MMM............FFFFFF
MMM.2.2.2.....FFFFFFF
FFF.........MWWWWWTFF
..........FMMWWW...FF
..........FFFFF......
..........FFFFF......
......FMM....FF......
......FFMWWWWWWM.....
......FFFFFFWWWMT....
..M...FFFFFF.........
..M....WWWFFF........
..M....WWWFFF.......M
..M....WWWFFF......MM
..M....CYY........MMM
.....................
.....................
.....................
MMM........YYC....M..
MM......FFFWWW....M..
M.......FFFWWW....M..
........FFFWWW....M..
.........FFFFFF...M..
....TMWWWFFFFFF......
.....MWWWWWWMFF......
......FF....MMF......
......FFFFF..........
......FFFFF..........
FF...WWWMMF..........
FFTWWWWWM.........FFF
FFFFFFF.....1.1.1.MMM
FFFFFF............MMM
FFFF..............MMM