.......WWWWWFF..FFFFF
.d.....WWWWWFF..FFd.F
.......WWWWWFFD.FF..F
.......WWWWWFF..TTFFF
aaaaa..FFFFF....DTFFF
.......FFFFF.........
............D........
.......2.............
.2NNNFFC.......NNNN..
..NWWFFF.......NL.N..
...WWFFF..D2D..N..N..
...WWFFF..YYY........
FFTWWFFF..MMM........
FFTWWFFF.............
FFTWWFFF.......DYC...
.....FFC.DBD...DYY...
........DDBDD........
...YYD...DBD.CFF.....
...CYD.......FFFWWTFF
.............FFFWWTFF
........MMM..FFFWWTFF
........YYY..FFFWW...
..NK.N..D1D..FFFWW...
..N..N.......FFFWWN1.
..NNNN.......CFFNNN..
........D....1.......
.....................
.........FFFFF.......
FFFT.D...FFFFF..aaaaa
FFFTT..FFWWWWW..D....
Ff.FF..FFWWWWWD...f..
F..FF..FFWWWWW.......
FFFFF..FFWWWWW.......