........2.2.2........
.....................
..FFFFFFF...FFFFFFF..
..FFFFFFF...FFFFFFF..
..FFMMMFF...FFMMMFF..
..FFMMMFF...FFMMMFF..
..FFMMMFF...FFMMMFF..
..FFMMMFF...FFMMMFF..
..FFFFFFF...FFFFFFF..
..FFFFFFF...FFFFFFF..
.....................
.....................
............FFFFFFFFF
C...........FFFFFFFFF
aaaaaaaaa...FFFFFFFFF
WWWWWWWWW...WWWWWWWWW
WWWWWWWWW...WWWWWWWWW
WWWWWWWWW...WWWWWWWWW
FFFFFFFFF...aaaaaaaaa
FFFFFFFFF...........C
FFFFFFFFF............
.....................
.....................
..FFFFFFF...FFFFFFF..
..FFFFFFF...FFFFFFF..
..FFMMMFF...FFMMMFF..
..FFMMMFF...FFMMMFF..
..FFMMMFF...FFMMMFF..
..FFMMMFF...FFMMMFF..
..FFFFFFF...FFFFFFF..
..FFFFFFF...FFFFFFF..
.....................
........1.1.1........