.....................
.....................
.....................
.........MMM.........
C.....FMMMc..........
CC....FFFF......M....
M.............MMM....
....MMMMM.........FF.
....MMFFFFFFFFFFFFFF.
....M.FFFFFFFFFFFFFF.
......FFWWWWWWWWFFFF.
........WWWWWWWW.....
...........NNN.....2.
...M.......NT........
...MF......N.......2.
...FF................
.1.................2.
................FF...
.1.......N......FM...
........TN.......M...
.1.....NNN...........
.....WWWWWWWW........
.FFFFWWWWWWWWFF......
.FFFFFFFFFFFFFF.M....
.FFFFFFFFFFFFFFMM....
.FF.........MMMMM....
....MMM.............M
....M....c.FFFF....CC
...........MMMF.....C
.........MMM.........
.....................
.....................
.....................