MMFFFMMMFFMFFMMMFFFMM
MMFFFMMMFFMFFMMMFFFMM
MMFFFMMMFFMFFMMMFFFMM
MMFFFFFFFFFFFFFFFFFMM
MMFFFFFFFFFFFFFFFFFMM
.....................
.....................
....WWWWWWWWWWWWW....
....WWWWWWWWWWWWW....
..FFT...........TFF..
..FFF...2.2.2...FFF..
..FFF...........FFF..
......WWWWWWWWW......
......WWWWWWWWW......
...........FFMM......
...........FFMM......
.....................
......MMFF...........
......MMFF...........
......WWWWWWWWW......
......WWWWWWWWW......
..FFF...........FFF..
..FFF...1.1.1...FFF..
..FFT...........TFF..
....WWWWWWWWWWWWW....
....WWWWWWWWWWWWW....
.....................
.....................
MMFFFFFFFFFFFFFFFFFMM
MMFFFFFFFFFFFFFFFFFMM
MMFFFMMMFFMFFMMMFFFMM
MMFFFMMMFFMFFMMMFFFMM
MMFFFMMMFFMFFMMMFFFMM