NNNNN...........NNNNN
C.......2.2.2.......C
.....................
........NNNNN........
....FF..YY...........
....FF..........T..FF
...MMF.............FF
...XXF.............FN
....FF......FF.....FN
....FF......FF.....FN
........T...NF....FFN
FF..FF......NF....FFN
FF..FF......NF.FWWWWW
F..YNF......NF.FWWWWW
F..YNF......NF.FWWWWW
F...NF.FWWWWWF.FN..FF
F...NF.FWWWWWF.FN...F
FF..NF.FWWWWWF.FN...F
WWWWWF.FN......FNY..F
WWWWWF.FN......FNY..F
WWWWWF.FN......FF..FF
NFF....FN......FF..FF
NFF....FN...T........
NF.....FF......FF....
NF.....FF......FF....
NF.............FXX...
FF.............FMM...
FF..T..........FF....
...........YY..FF....
........NNNNN........
.....................
C.......1.1.1.......C
NNNNN...........NNNNN