CC......FFFFF...FFFCC
CC......FFFFF...FFFFF
..........XMM...aFFFF
................aaaFF
.FFFMMMX..2..........
.FFFMMFF.....2.......
..FMMFFF........2....
..................NFF
...........YYY....NFF
............YYC...NFF
YY...........YY...NFF
YC.....CC.....C...FFF
C...MFFFF.........FFF
..f.MFFFFFF..........
....MFFFFFF..........
...XMMMWWFFF.WWW.....
.....WWWWFFFWWWW.....
.....WWW.FFFWWMMMX...
..........FFFFFFMf...
..........FFFFFFM....
FFF.........FFFFM...C
FFF...C.....CC.....CY
FFN...YY...........YY
FFN...CYY............
FFN....YYY...........
FFN..................
....1........FFFMMF..
.......1.....FFMMFFF.
..........1..XMMMFFF.
FFaaa................
FFFFa...MMX..........
FFFFF...FFFFF......CC
CCFFF...FFFFF......CC