FFFFFFFFF............
FFF..................
........2.2.2........
.....M.........M.....
MMMMMMFFF......MMMMMM
WWWWFFFFF.T......WWWW
WWWW..FFF........WWWW
WWWW..FFFF.......WWWW
...MMMMMMF.......MMMM
...M..FFFF.......M...
...........T.........
......T..............
.....................
F....................
F...................F
F...................F
F...................F
F...................F
F...................F
....................F
.....................
..............T......
.........T...........
...M.......FFFF..M...
MMMM.......FMMMMMM...
WWWW.......FFFF..WWWW
WWWW........FFF..WWWW
WWWW......T.FFFFFWWWW
MMMMMM......FFFMMMMMM
.....M.........M.....
........1.1.1........
..................FFF
............FFFFFFFFF