YYCB....2.2.2....BCYY
YC.................CY
YD.................DY
DD.................DD
D........FFF........D
......WWWFFFWWW......
.....WWWWFFFWWWW.....
....WWWWWFFFWWWWW....
...WWWWWWFFFWWWWWW...
..FWWWWWWFFFWWWWWWF..
.FFWWWWWWFFFWWWWWWFF.
FFF......FFF......FFF
FFF......FFF......FFF
TFF......FFF......FFT
MFF......FFF......FFM
MFF......FFF......FFM
MMM.....TIIIT.....MMM
MFF......FFF......FFM
MFF......FFF......FFM
TFF......FFF......FFT
FFF......FFF......FFF
FFF......FFF......FFF
.FFWWWWWWFFFWWWWWWFF.
..FWWWWWWFFFWWWWWWF..
...WWWWWWFFFWWWWWW...
....WWWWWFFFWWWWW....
.....WWWWFFFWWWW.....
......WWWFFFWWW......
D........FFF........D
DD.................DD
YD.................DY
YC.................CY
YYCB....1.1.1....BCYY