WWWWWBB.2.2.2.BBWWWWW
WWWWWBB.......BBWWWWW
WWWWW.......D...WWWWW
WWWWW...........WWWWW
WWWWWD..........WWWWW
.....................
................FF...
...D............FF...
...XX.....D.....XX...
...FF....III.........
...FF................
.....................
....................D
....bbbbbbbbbbbbb....
D...b...D......Db....
WWWWb.FFFFFFFFF.bWWWW
WWWWb.FFFFFFFFF.bWWWW
WWWWb.FFFFFFFFF.bWWWW
....bD......D...b...D
....bbbbbbbbbbbbb....
D....................
.....................
................FF...
.........III....FF...
...XX.....D.....XX...
...FF............D...
...FF................
.....................
WWWWW..........DWWWWW
WWWWW...........WWWWW
WWWWW...D.......WWWWW
WWWWWBB.......BBWWWWW
WWWWWBB.1.1.1.BBWWWWW