..........M..........
...H......M..........
..N...MMMMM..........
..N..........NNNNN...
..N..............N...
..N..............N...
..NNN................
..............2.2....
.......aaaaa..CC....B
..............CC2..BB
..................BBB
N.FF.N..Y.........TFF
N.FF.N..YY..aaaa..TFF
N.FF.N..YY...........
N.FF.N..YY...........
.........YYY..aaaa...
.........MMM.........
...aaaa..YYY.........
...........YY..N.FF.N
...........YY..N.FF.N
FFT..aaaa..YY..N.FF.N
FFT.........Y..N.FF.N
BBB..................
BB..1CC..............
B....CC..aaaaa.......
....1.1..............
................NNN..
...N..............N..
...N..............N..
...NNNNN..........N..
..........MMMMM.G.N..
..........M..........
..........M..........