..2.2.2..............
.....................
.........CCC.........
..........YYYFF...CCC
..........FFFFFFFYYYY
.............FFFFF.YY
................FF.CC
......M...M..........
.....MM..FMM.........
.....MFFFFWWWFF.....C
....MMFFFFWWWWFFF.YYY
y....FFF...WWWFFF....
...........TWWWFFFF..
MM..........WWWFFFF..
M............WWFFF...
M...FFF......WWFFF...
....FFTT.....TTFF....
...FFFWW......FFF...M
...FFFWW............M
..FFFFWWW..........MM
..FFFFWWWT.........y.
....FFFWWW...FFF.....
YYY.FFFWWWWFFFFMM....
C.....FFWWWFFFFM.....
.........MMF..MM.....
..........M...M......
CC.FF................
YY.FFFFF.............
YYYYFFFFFFF..........
CCC...FFYYY..........
.........CCC.........
.....................
..............1.1.1..