YT......2.2.2......TY
C...................C
.....................
...aaaaaa...aaaaaa...
...aWWWWa...aWWWWa...
...aWWWWa...aWWWWa...
...aWWWWa...aWWWWa...
...aWWWWa...aWWWWa...
...aaaaaa...aaaaaa...
.....................
.....................
.....................
WWW...WWWFFFWWW...WWW
WWW...WWWFFFWWW...WWW
WWW...WWWFFFWWW...WWW
WWW...FFFFFFFFF...WWW
WWW...FFFFFFFFF...WWW
WWW...FFFFFFFFF...WWW
WWW...WWWFFFWWW...WWW
WWW...WWWFFFWWW...WWW
WWW...WWWFFFWWW...WWW
.....................
.....................
.....................
...aaaaaa...aaaaaa...
...aWWWWa...aWWWWa...
...aWWWWa...aWWWWa...
...aWWWWa...aWWWWa...
...aWWWWa...aWWWWa...
...aaaaaa...aaaaaa...
.....................
C...................C
YT......1.1.1......TY