FFFFF...2.2.2...FFFFF
FFFF.............FFFF
FFMM...N.....N...MMFF
FFMY...N.....N...YMFF
F.F...DNFFFFFNB...F.F
......FNNNNNNNF......
......FF.....FF......
..T...............T..
.FMF.....FFF.....FMF.
FFMF.....FFF.....FMFF
MMMF..FF.FFF.FF..FMMM
MMF..FMMFFFFFMMF..FMM
MF...FMMFFFFFMMF...FM
M..F.FMF.FFF.FMF.F..M
Y.FF..F..FFF..F..FF.C
Y.FFF....FFF....FFF.C
C.FFF....MMM....FFF.C
C.FFF....FFF....FFF.Y
C.FF..F..FFF..F..FF.Y
M..F.FMF.FFF.FMF.F..M
MF...FMMFFFFFMMF...FM
MMF..FMMFFFFFMMF..FMM
MMMF..FF.FFF.FF..FMMM
FFMF.....FFF.....FMFF
.FMF.....FFF.....FMF.
..T...............T..
......FF.....FF......
......FNNNNNNNF......
F.F...BNFFFFFND...F.F
FFMY...N.....N...YMFF
FFMM...N.....N...MMFF
FFFF.............FFFF
FFFFF...1.1.1...FFFFF