MM............2.2.2..
M........FFF.........
M...FFF..MMM.........
MMMMFFF..MMMM........
MMMFFFF...MMM...FFF..
YYCFFF....NNN...CYF..
FFFFFF...............
FFFFF................
FFF..................
....CY....FFNNN......
..........FFMMM......
..........FFFF.......
...........FFF....NNN
..C....CYY......FFMMM
........CY......FFMMM
FFF.............FFFMM
FFFF.............FFFF
MMFFF.............FFF
MMMFF......YC........
MMMFF......YYC....C..
NNN....FFF...........
.......FFFF..........
......MMMFF..........
......NNNFF....YC....
..................FFF
................FFFFF
...............FFFFFF
..FYC...NNN....FFFCYY
..FFF...MMM...FFFFMMM
........MMMM..FFFMMMM
.........MMM..FFF...M
.........FFF........M
..1.1.1............MM