....FFFFMMM.2.2.2....
.....FFFMMM..........
.....FFFFMM.....FFF..
.........CC.....YYF..
................YYF..
.....................
YYY.....CCC..........
YY...................
....................M
FFFFF..CCC........CCM
FFFFF..MMM........MMM
FFF....MMM........M..
FF....FMM........MM..
FF.M..FFF............
...M..FFF............
...M..FM...........FF
FF.M...M.....M...M.FF
FF...........MF..M...
............FFF..M...
............FFF..M.FF
..MM........MMF....FF
..M........MMM....FFF
MMM........MMM..FFFFF
MCC........CCC..FFFFF
M....................
...................YY
..........CCC.....YYY
.....................
..FYY................
..FYY.....CC.........
..FFF.....MMFFFF.....
..........MMMFFF.....
....1.1.1.MMMFFFF....