MMM...........MM..MMM
..............MM...YY
.....TT.2.2.2........
....TT...............
.....................
............MMM......
.....................
.....MF..........FFFM
.....MF..........FFFM
...FXMF..MMMMM....FFM
...FXMF..XXy......FFF
...FFFF..Y........FFF
..................FFF
YY...............FFF.
CC...........NNNNFFF.
............XXC..FF..
.....................
..FF..CXX............
.FFFNNNN...........CC
.FFF...............YY
FFF..................
FFF.....y..Y..FFFF...
FFF.......XX..FMXF...
MFF....MMMMM..FMXF...
MFFF..........FM.....
MFFF..........FM.....
.....................
......MMM............
.....................
...............TT....
........1.1.1.TT.....
YY...MM..............
MMM..MM...........MMM