........2.2.2........
.....................
..FF...............YY
..MM.........WWW...FF
..MM.........WWWW..FF
..M..........WWWW..FF
..M..........TWWW..FF
.....................
.....................
......FF.............
......FF.WWW..FF.....
......FF.WWWWTFFMM..F
C...CMFFFWWWWWFFMM.FF
Y...MMFFFWWWWWFFMM.FF
...MMYFFFNNNNNFF...FF
....FFFFFFFFFFFFFFFFF
FFFFFFFFFFFFFFFFFFFFF
FFFFFFFFFFFFFFFFF....
FF...FFNNNNNFFFYMM...
FF.MMFFWWWWWFFFMM...Y
FF.MMFFWWWWWFFFMC...C
F..MMFFTWWWW.FF......
.....FF..WWW.FF......
.............FF......
.....................
.....................
FF..WWWT..........M..
FF..WWWW..........M..
FF..WWWW.........MM..
FF...WWW.........MM..
YY...............FF..
.....................
........1.1.1........