........2.2.2........
.....................
..D....D.....D....D..
....BRR.......RRB....
....BRR.......RRB....
.....RRD.....DRR.....
...................XX
....aaa..NNN..aaa..RR
MM.................RR
RR.....D..D..D.....RR
RR.bbbbbbbbbbbbbbb.RR
RR.b.......BBB...b...
RR.b.......RRRRR.b...
..Db.......RRRRR.bD..
...b.....C....RR.b...
...b.RRDNNNNNDRR.b...
T.Db.RR.NTTTN.RR.bD.T
...b.RRDNNNNNDRR.b...
...b.RR....C.....b...
..Db.RRRRR.......bD..
...b.RRRRR.......b.RR
...b...BBB.......b.RR
RR.bbbbbbbbbbbbbbb.RR
RR.....D..D..D.....RR
RR.................MM
RR..aaa..NNN..aaa....
XX...................
.....RRD.....DRR.....
....BRR.......RRB....
....BRR.......RRB....
..D....D.....D....D..
.....................
........1.1.1........