...BBBB......C.......
...B.................
.....................
...............CC....
.....BB..............
.....................
............FFF......
...........MMFFMMMM..
.2.2.2.......FF......
.............FF......
.FFF....C....FF......
MMFFMMMMMF...FF......
..FF...FFF...FF..FF..
..FF.........FF..FF..
..FFC.......MFFMMMF..
..FF.........FF..FF..
..FF.............FF..
..FF..FF.........FF..
..FMMMFFM.......CFF..
..FF..FF.........FF..
..FF..FF...FFF...FF..
......FF...FMMMMMFFMM
......FF....C....FFF.
......FF.............
......FF.......1.1.1.
..MMMMFFMM...........
......FFF............
.....................
..............BB.....
....CC...............
.....................
.................B...
.......C......BBBB...