........2.2.2........
.....................
...MMM.........MMM...
...CFF.........FFF...
....FF.........FFF...
....FF.........FFM...
FFFFFF......MMMFFM...
FFFFFF.....FFFFFFFFFF
MM..FF.....FFFFFFFFFF
....FF...........XXFF
....FF...........XCFF
....MM.............FF
....MMC............FF
L.FFFFFFFFFFMC.....FF
..FFFFFFFFFFMMM....FF
WWWWWWWWWFFFWWWWWWWMM
WWWWWWWWWFFFWWWWWWWWW
MMWWWWWWWFFFWWWWWWWWW
FF....MMMFFFFFFFFFFK.
FF.....CMFFFFFFFFFF..
FF............CMM....
FF.............MM....
FFCX...........FF....
FFXX...........FF....
FFFFFFFFFF.....FF..MM
FFFFFFFFFF.....FFFFFF
...MFFMMM......FFFFFF
...MFF.........FF....
...FFF.........FF....
...FFF.........FFC...
...MMM.........MMM...
.....................
........1.1.1........