...FF...2.2.2........
.................FF..
.................FF..
....FF...............
....FF.M.............
..M....M........FF...
..M....MMM....M.FF...
..M..FFWWW....M.....M
..M..FFWWW..MMM.....M
.....FFWWWy.WWWFF...M
.....FFFFC..WWWFF...M
.....FFFF...WWWFF....
.....YYFF...CFFFF....
.....CC......FFFF....
.............FFYY....
...............CC....
.....................
....CC...............
....YYFF.............
....FFFF......CC.....
....FFFFC...FFYY.....
....FFWWW...FFFF.....
M...FFWWWy.CFFFF.....
M...FFWWW..WWWFF.....
M.....MMM..WWWFF..M..
M.....M....WWWFF..M..
...FF.M....MMM....M..
...FF........M....M..
.............M.FF....
...............FF....
..FF.................
..FF.................
........1.1.1...FF...