WWWWWWWWWWWWWWWWWWWWW
WWWWWWWWWWWWWWWWWWWWW
WWWFFFFFFFFFWWWWWWWWW
WWWFFFFFFFFFFFFFFWWWW
...FFFFFFFFFFFFFFWWWW
...............FF..FF
FF...TMMM...T..FF..FF
FF....M............FF
FF.................FF
FF......2.2.2......FF
FF...................
FF....M..............
MF.c..M.........e....
MF...................
MM.................CC
MM................NMM
MMNNNN.........NNNNMM
MMN................MM
CC.................MM
...c............e..FM
..............M....FM
..............M....FF
...................FF
FF......1.1.1......FF
FF.................FF
FF............M....FF
FF..FF..T...MMMT...FF
FF..FF...............
WWWWFFFFFFFFFFFFFF...
WWWWFFFFFFFFFFFFFFWWW
WWWWWWWWWFFFFFFFFFWWW
WWWWWWWWWWWWWWWWWWWWW
WWWWWWWWWWWWWWWWWWWWW