........2.2.2........
.....................
.....................
BBB..T...MMM...T..BBB
.....................
.....................
......XXX...XXX......
.....................
.....................
....YYYaaaaaaaYYY....
......WWWWWWWWW......
......WWWWWWWWW......
FFF...WWWWWWWWW...FFF
FFF......MMM......FFF
...Y.............C...
...Y.............C...
CCCY.............CYYY
...Y.............C...
...Y.............C...
FFF......MMM......FFF
FFF...WWWWWWWWW...FFF
......WWWWWWWWW......
......WWWWWWWWW......
....YYYaaaaaaaYYY....
.....................
.....................
......XXX...XXX......
.....................
.....................
BBB..T...MMM...T..BBB
.....................
.....................
........1.1.1........