........2.2.2........
...FFFFFFFFFFFFFFF...
...FFFFFFFFFFFFFFF...
..TFFYMMTFFCFFMMMM.c.
..TFFYMMTFFCFFMMMM...
.....................
.....................
......WW...BB........
..MM..WW...BB..XXFFFF
..MM.......BB..XXFFFF
...............XXFFFF
......YY.............
FFT...Y....CC........
FFT...Y....CC........
.....YY..........MMFF
FFFFFFFFFFFFFFFFFMMFF
FFFFFFFFFFFFFFFFFFFFF
FFMMFFFFFFFFFFFFFFFFF
FFMM..........YY.....
........CC....Y...TFF
........CC....Y...TFF
.............YY......
FFFFXX...............
FFFFXX..BB.......MM..
FFFFXX..BB...WW..MM..
........BB...WW......
.....................
.....................
c..MMMMFFCFFTMMYFFT..
...MMMMFFCFFTMMYFFT..
...FFFFFFFFFFFFFFF...
...FFFFFFFFFFFFFFF...
........1.1.1........