FF......2.2.2........
FFd..................
FF..N..N........TTT..
NNNNN..N..TTTT..DDT..
.......N..T.....DD...
.......N..T.....DD...
....N..N..T...TTT....
....N..N........T....
FFd.N...........T....
FF..N...........T....
FFNNN..YYFFFCC.......
.......YYFFFCC.......
.......e....f........
.....................
FFFaaaaFFaaaFFaaaaFFF
FFFaWWWFFWWWFFWWWaFFF
FFFaWWWFFWWWFFWWWaFFF
FFFaWWWFFWWWFFWWWaFFF
FFFaaaaFFaaaFFaaaaFFF
.......e....f........
.....................
.......CCFFFYY.......
.......CCFFFYY..NNNFF
....T...........Nc.FF
....T...........N..FF
....T........N..N....
....TTT...T..N..N....
...DD.....T..N.......
...DD.....T..N.......
..TDD..TTTT..N..NNNNN
..TTT........N..Nc.FF
...................FF
........1.1.1......FF