........2.2.2........
.....................
...................MM
YYMMM..............MM
MMM...........MM.....
MMF.....FFF...MMM....
MMF.....MMM........FF
MF....MMM..........FF
MF....FFF.......WWWFF
................WWWFF
...................FF
...WW...............F
.c.WWI...MM....II...F
...WWII.......III...F
...WW................
aaaa.................
.....................
.................aaaa
................WW...
F...III.......IIWWc..
F...II....MM...IWW...
F...............WW...
FF...................
FFWWW................
FFWWW.......FFF....FM
FF..........MMM....FM
FF........MMM.....FMM
....MMM...FFF.....FMM
.....MM...........MMM
MM..............MMMYY
MM...................
.....................
........1.1.1........