MMMMFFFFFFFMMMMMM....
MC...FFFFFFFFFMC.....
M.......FFFFFFFF.....
M..........FFFFF.....
..2.2.2..............
...............TT....
.......MM............
....YMMMM....FFFF....
....YY....FFFFFFF....
.......FFFFFFFFF.....
......FFFFFFF........
...MY.FFFF......MM...
............MMMMMM...
............MM.......
.....FFFF............
.....FFFFFFF....MM...
......FFFFFFFFF......
...MM....FFFFFFF.....
............FFFF.....
.......MM............
...MMMMMM............
...MM......FFFF.YM...
........FFFFFFF......
.....FFFFFFFFF.......
....FFFFFFF....YY....
....FFFF....MMMMY....
............MM.......
....TT...............
..............1.1.1..
.....FFFFF..........M
.....FFFFFFFF.......M
.....CMFFFFFFFFF...CM
....MMMMMMFFFFFFFMMMM