.....................
.............FFFFF...
.............WWWFFFFF
.............WWWFFWWW
..aaaaa......FFFFFWWW
..a.......M......FFFF
..a......MMM..XX.....
..........M...FF.....
..........M...FF.....
..NNNNNN..M..BFFB...B
..FFFFFF..M..NNNN..NN
..FFFFFF..M..NFFN...N
..NNNNNN......FF.....
..............FF.....
..........XXX..222a..
............Xaaaaaa..
.....................
..aaaaaaX............
..a111..XXX..........
.....FF..............
.....FF......NNNNNN..
N...NFFN..M..FFFFFF..
NN..NNNN..M..FFFFFF..
B...BFFB..M..NNNNNN..
.....FF...M..........
.....FF...M..........
.....XX..MMM......a..
FFFF......M.......a..
WWWFFFFF......aaaaa..
WWWFFWWW.............
FFFFFWWW.............
...FFFFF.............
.....................