MMMDD...2.2.2....BMMM
MMMD..............MMM
YY.................YY
.....................
......MMM...MMM......
......MMM...MMM......
T...................C
MMM...............MMM
MMM...............MMM
....................T
.....................
......FFF...FFF......
......FFF...FFF......
...II.FFF...FFF.II...
...II.FFF...FFF.II...
...II.FFFFFFFFF.II...
...II.FFFFFFFFF.II...
...II.FFFFFFFFF.II...
...II.FFF...FFF.II...
...II.FFF...FFF.II...
......FFF...FFF......
......FFF...FFF......
.....................
T....................
MMM...............MMM
MMM...............MMM
C...................T
......MMM...MMM......
......MMM...MMM......
.....................
YY.................YY
MMM..............DMMM
MMMB....1.1.1...DDMMM