.........2.2.2.......
.....................
.....................
C....................
CC......TFFF.........
MMMM.....FFF...FF..L.
WWMMMX.........FC....
WWMMMMMM......FFNNNNN
MMM...MM......FF...CC
M.............FF...CC
....F....FFFFFFF.....
.FFFF....FFFNNNN.....
.FF...MM.FFF.........
FFF.MMMM.............
FFMMMM...........FFF.
FFM...........T...FF.
FFF...............FFF
.FF...T...........MFF
.FFF...........MMMMFF
.............MMMM.FFF
.........FFF.MM...FF.
.....NNNNFFF....FFFF.
.....FFFFFFF....F....
CC...FF.............M
CC...FF......MM...MMM
NNNNNFF......MMMMMMWW
K...CF.........XMMMWW
....FF...FFF.....MMMM
.........FFFT......CC
....................C
.....................
.....................
.......1.1.1.........