......2.2.2..XXX..XXX
..................MMM
..................MMM
F.................MMM
FFF................MM
FFFMMMMMCF.........MM
FFFMM..FFF......C..MM
FFF........FFF.....XX
.FF........FFF.......
.FF........FFFFFF....
.........MMMMFFFF....
...MM.......MMMFF....
...M..........M......
.................MFF.
.................MFF.
......C..............
.....................
..............C......
.FFM.................
.FFM.................
......M..........M...
....FFMMM.......MM...
....FFFFMMMM.........
....FFFFFF........FF.
.......FFF........FF.
XX.....FFF........FFF
MM..C......FFF..MMFFF
MM.........FCMMMMMFFF
MM................FFF
MMM.................F
MMM..................
MMM..................
XXX..XXX..1.1.1......