MMMM....2.2.2........
MMMM.................
MM...................
MM.........YYY.......
MMM........CC........
FFF...........d......
FFF....FFF......C....
FFF....FFFFF...YY....
FF.....FFFFFFF.......
FF.YYY.FWWFFFF.......
FF..C..FWWWWFF.......
FF......WWWWMMM......
FF........WWMMWWFF...
FF........d.MMWWFF...
FF.C..........WWFF...
...II..........FFF...
.....................
...FFF..........II...
...FFWW..c.......C.FF
...FFWWMM..........FF
...FFWWMMWW........FF
......MMMWWWW......FF
.......FFWWWWF..C..FF
.......FFFFWWF.YYY.FF
.......FFFFFFF.....FF
....YY...FFFFF....FFF
....Cc.....FFF....FFF
..................FFF
........CC........MMM
.......YYY.........MM
...................MM
.................MMMM
........1.1.1....MMMM