................CCC..
..................C..
TT...YY........D.D.D.
TT...YFFFFFFNNNN.....
T....YFFFFFFFFFNNN.D.
......FFYYFFFFFFFN...
......FFYFFFFFFFFN...
......FFYFFFFFFFFN...
.......FFFFMMMMFFN...
.......FFFFMMMMFFFFFF
....B......MMc.FFFFFF
NNNBBBNNN..MM..FFFFFF
2FFFFFFFC..MMMMNNNFFF
FFFFFFFFC..MMMM....FF
2FFFFFFFF............
FFFNFFFFF....FFFFNN..
2FFNFFFFFTTTFFFFFNFF1
..NNFFFF....FFFFFNFFF
............FFFFFFFF1
FF....MMMM..CFFFFFFFF
FFFNNNMMMM..CFFFFFFF1
FFFFFFc.MM..NNNBBBNNN
FFFFFF..MM......B....
FFFFFFMMMMFFFF.......
...NFFMMMMFFFF.......
...NFFFFFFFFYFF......
...NFFFFFFFFYFF......
...NFFFFFFFYYFF......
.D.NNNFFFFFFFFFY....T
.....NNNNFFFFFFY...TT
.D.D.D........YY...TT
..C..................
..CCC................