........2.2.2........
.....................
..FFM..MFFFFFM..MFF..
..FFM..MFFFFFM..MFF..
..MMM..MMMMMMM..MMM..
.....................
.....................
FFWWW..WWWWWWW..WWWFF
FFWWW..WWWWWWW..WWWFF
FF.................FF
FF.................FF
FF...TM..MMM..FFF..FF
FF..MMM..MM...FFF..FF
FF.......M.........FF
FF.................FF
FF...CM.......MMM..FF
FF..YYM.......MYY..FF
FF..MMM.......MC...FF
FF.................FF
FF.........M.......FF
FF..FFF...MM..MMM..FF
FF..FFF..MMM..MT...FF
FF.................FF
FF.................FF
FFWWW..WWWWWWW..WWWFF
FFWWW..WWWWWWW..WWWFF
.....................
.....................
..MMM..MMMMMMM..MMM..
..FFM..MFFFFFM..MFF..
..FFM..MFFFFFM..MFF..
.....................
........1.1.1........