TD.......FFFFFWWWWWWW
D........FFFFFWWWWWWW
..2.2.2..FFFFFWWWWWWW
.........WWW.........
.........WWW.........
....D....WWW.........
....DD...WWW.........
..MMMMM..WWW..M......
..MFFFF..WWW..M.....C
..MFFFF..WWW..MY...CY
.........FFF..MMMMMMM
.........FFF.....DBBB
D........FFF......BBB
MMM..YY..WWW......MMM
MFF..YY..WWW......FFM
MFF..T...WWW..D...FFM
MFF......WWW......FFM
MFF...D..WWW...T..FFM
MFF......WWW..YY..FFM
MMM......WWW..YY..MMM
BBB......FFF........D
BBBD.....FFF.........
MMMMMMM..FFF.........
YC...YM..WWW..FFFFM..
C.....M..WWW..FFFFM..
......M..WWW..MMMMM..
.........WWW...DD....
.........WWW....D....
.........WWW.........
.........WWW.........
WWWWWWWFFFFF..1.1.1..
WWWWWWWFFFFF........D
WWWWWWWFFFFF.......DT