YY..................B
Y.......2.2.2........
.....................
.....................
.....................
..CY...........FFF...
..MMMMWWW......NNN...
..FFFMWWW............
..FFFMWWW............
..FFFMWW.............
..FFFMWW.............
..FFFM...............
...FFM...............
........FFFFF..T.....
.......FFFFFFF.MMMvvv
...WWW.FFFIFFF.WWW...
...WWW.FFIIIFF.WWW...
...WWW.FFFIFFF.WWW...
vvvMMM.FFFFFFF.......
.....T..FFFFF........
...............MFF...
...............MFFF..
.............WWMFFF..
.............WWMFFF..
............WWWMFFF..
............WWWMFFF..
...NNN......WWWMMMM..
...FFF...........YC..
.....................
.....................
.....................
........1.1.1.......Y
B..................YY