.....................
.......222...........
..............MM...MM
...........MMMMM...MM
.....................
.....................
.....................
.....CC..MMMMMMM...MM
.........FWWWWMM...MM
.......FFFWWWW.......
...FF..FFFWWWW.......
...FFCCFFFWWWWF......
.......FFFFFFFF......
.......FFFFFFFF..XXF.
.................FFF.
.................FFF.
..........X..........
.FFF.................
.FFF.................
.FXX..FFFFFFFF.......
......FFFFFFFF.......
......FWWWWFFFCCFF...
.......WWWWFFF..FF...
.......WWWWFFF.......
MM...MMWWWWF.........
MM...MMMMMMM..CC.....
.....................
.....................
.....................
MM...MMMMM...........
MM...MM..............
...........111.......
.....................