CC......2.2.2......YY
CC.................YY
CC.................YY
CC.....T.....T.....YY
MM...WWIFFFFFIWW...MM
FF...WWIFFFFFIWW...FF
FF...WWIFFFFFIWW...FF
FF...WWIFFFFFIWW...FF
FF...WWIFFFFFIWW...FF
FF...WWIFFFFFIWW...FF
MM...WWIFFFFFIWW...MM
B....WWIFFFFFIWW....T
.....WWIFFFFFIWW.....
.....WWIFFFFFIWW.....
.....WWIIFFFIIWW.....
FFF..WWWIFFFIWWW..FFF
MMF..WWWIFFFIWWW..FMM
FFF..WWWIFFFIWWW..FFF
.....WWIIFFFIIWW.....
.....WWIFFFFFIWW.....
.....WWIFFFFFIWW.....
T....WWIFFFFFIWW....B
MM...WWIFFFFFIWW...MM
FF...WWIFFFFFIWW...FF
FF...WWIFFFFFIWW...FF
FF...WWIFFFFFIWW...FF
FF...WWIFFFFFIWW...FF
FF...WWIFFFFFIWW...FF
MM...WWIFFFFFIWW...MM
YY.....T.....T.....CC
YY.................CC
YY.................CC
YY......1.1.1......CC