WWWWWWWWWWWWWWWWWWWWWWWWWWWWWWWWWWWWWWWWWWWWWWWWWWWWWWWWWWWW
WWWWWWWWWWWWWWWWWWWWWWWWWWWWWWWWWWWWWWWWWWWWWWWWWWWWWWWWWWWW
WWWWWWWWWWWWWWWWWWWWWWWWWWWWWWWWWWWWWWWWWWWWWWWWWWWWWWWWWWWW
WWWWWWWWWWWWWWWWWWWWWWWWWWWWWWWWWWWWWWWWWWWWWWWWWWWWWWWWWWWW
WWWWWWWWWWWWWWWWWWWWWWWWWWÈFWFÈWWWWWWWWWWWWWWWWWWWWWWWWWWWWW
WWWWWWWWWWWWWWWWWWWWWWWWWW....CWWWWWWWWWWWWWWWWWWWWWWWWWWWWW
WWWWWWWWWWWWWWWWWWWWWWWWWW..Ë..FWWWWWWWWWWÊWWWWWWWWWWWWWWWWW
WWWWWWWWWWWWWWWWWWWWWWWWWW....FFWWWWWWWWWWWWWWWWWWWWWWWWWWWW
WWWWWWWWWWWWWWWWWWWWWWWWWWW..FFWWWWWWWWWWWWWWWWWWWWWWWWWWWWW
WWWWWWWWW...WWWWWWWWWWWWWWWYFFCWWWWWWWWWWWWWWWWWWWWWWWWWWWWW
WWWWWWWWW.È.WWWWWWWWWWWWWWWWWWWWWWWWWWWWWWWWWWWWWWWWWWWWWWWW
WWWWWWWWWW..WWWWWWWWWWWWWWWWWWWWWWWWWWWWWWWWWWWWWWWWWWWWWWWW
WWWWWWWWWWWWWWWWWWWWWWEEEEEEEEEEEEEEEEWWWWWWWÊWWWWWWWWWWWWWW
WWWWWWWWWWWWWWWWWWWWEEEFFF........FFFEEEWWWWWWWWWWWWWWWWWWWW
WWWWWWWWWWWWWWWWWWEEEFFFF..........FFFFEEEWWWWWWWWWWWÊWWWWWW
WWWWWWWWWWWWWWWWWEEFFFF.....D........FFFFEEWWWWWWWWWWWWWWWWW
WWWWWWWWWWWWWWWWEE.FFF.......WW.......FFF.EEWWWWWWWWWWWWWWWW
WWWWWWWWWWWWWWWEE...........WWWW...........EEWWWWWWWWWWWWWWW
WWWWWWWWWWWWWWEE........D..WWWWWW...........EEWWWWWWWWWWWWWW
WWWWWWWWWWWWWWEFF..........WWWWWW......D...FFEWWWWWWWWWWWWWW
WWWWF.WWWWWWWEEFF...........WWWW...........FFEEWWWWWWWWWWWWW
WWWW.É.WWWWWWEFFF.....WW.....WW.....WW.....FFFEWWWWWWÊWWWWWW
WWWWF..WWWWWEEFF.....WWWW..........WWWW.....FFEEWWWWWWWWWWWW
WWWWWWWWWWWWEFF.....WW33WW........WW33WW.....FFEWWWWWWWWWWWW
WWWWWWWWWWWWEFF..D..WW33WW........WW33WW.....FFEWWWWWWWWWWWW
WWWWWWWWWWWWEF.......WWWW..........WWWW.......FEWWWWWWWWWWWW
WWWWWWWWWWWWE.........WW....WWWW....WW.........EWWWWWWWWWWWW
WWWWWWWWWWWWE..............WWWWWW..............EWWW.FFFWWWWW
WWWWÊWWWWWWWE....WW.......WWWWWWWW.......WW..D.EWWW...F.WWWW
WWWWWWWWWWWWE...WWWW.....WWWW.DWWWW.....WWWW...EWWW..Ë..ÈWWW
WWWWWWWWFFFWE...WWWW..D..WWWW2.WWWW.....WWWW...EWWW.......WW
WWWWWWWWCT.WE....WW.......WWWWWWWW.......WW....EWWWC.....FWW
WWWWWWWWW.WWE..............WWWWWW..............EWWWW.FFWFFWW
WWWWWWWWWWWWE.........WW....WWWW....WW.........EWWWWWW....WW
WWWWWWWWWWWWEF.......WWWW..........WWWW.......FEWWWWWWFÈWWWW
WW..FWWWWWWWEFF..D..WW33WW.....D..WW33WW..D..FFEWWWWWWWWWWWW
WW.È.WWWWWWWEFF.....WW33WW........WW33WW.....FFEWWWWWWWWWWWW
WWFF.WWWWWWWEEFF.....WWWW..........WWWW.....FFEEWWWWWWWWWWWW
WWWWWWWWWWWWWEFFF.....WW.....WW.....WW.....FFFEWWWWWWWWWWWWW
WWWWWWWWWWWWWEEFF...........WWWW...........FFEEWWWWWWWWWWWWW
WWWWWWWWWWWWWWEFF.D......D.WWWWWW..........FFEWWWWWWWWWWWWWW
WWWWWWWWWWWWWWEE...........WWWWWW.......D...EEWWWWWF..WWWWWW
WWWWWWWWWWWWWWWEE...........WWWW...........EEWWWWWW.ÈFWWWWWW
WWWWWWWW...FWWWWEE.FFF.......WW.......FFF.EEWWWWWWWW.WWWWWWW
WWWWWWW..Ë.F.WWWWEEFFFF.....1..1.....FFFFEEWWWWWWWWWWWWWWWWW
WWWWWWWF....TWWWWWEEEFFFF..........FFFFEEEWWWWWWWWWWWWWWWWWW
WWWWWWWFF...FWWWWWWWEEEFFF........FFFEEEWWWWWWWWWWWWWWWWWWWW
WWWWWWWWF..FWWWWWWWWWWEEEEEEEEEEEEEEEEWWWWWWWWWWWWWWWWWWWWWW
WWWWWWWWW.ÈWWWWWWWWWWWWWWWWWWWWWWWWWWWWWWWWWWWW....ÈWWWWWWWW
WWWWWWWWWWWWWWWWWWWWWWWWWWWWWWWWWWWWWWWWWWWWWWW.É.FWWWWWWWWW
WWWWWWWWWWWWWWW...WWWWWWWWWWWWWWWWWWWWWNNNWWWWWW..WWWWWWWWWW
WWWWWWWWWWWWWWW.È.WWWWWWWW....WWWWWWWWWFFFWWWWWWWWWWWWWWWWWW
WWWWWWWWWWWWWWWFFWWWWWWWWWÉ.FÈWWWWWWWWCY..WWWWWWWWWWWWWWWWWW
WWWWWWWWWWWWWWWWWWWWWWWWWWWWF.WWWWWWWWW...WWWWWWWWWWWWWWWWWW
WWWWWWWWWWWWWWWWWWWWWWWWWWWWWWWWWWWWWWWWWWWWWWWWWWWWWWWÊWWWW
WWWWWWWWWWWWWWWWWWWWWWWWWWWWWWWWWWWWWWWWWWWWWWWWWWWWWWWWWWWW
WWWWWWWWWWWWWWWWWWWWWWWWWWWWWWWWWWWWWWWWWWWWWWWWWWWWWWWWWWWW
WWWWWWWWWWWWWWWWWWWWWWWWWWWWWWWWWWWWWWWWWWWWWWWWWWWWWWWWWWWW
WWWWWWWWWWWWWWWWWWWWWWWWWWWWWWWWWWWWWWWWWWWWWWWWWWWWWWWWWWWW
WWWWWWWWWWWWWWWWWWWWWWWWWWWWWWWWWWWWWWWWWWWWWWWWWWWWWWWWWWWW