111000007070700000111
100000000000000000001
100000000000000000001
000000000000000000000
000110001222100011000
000210001222100012000
000210001222100012000
000210001222100012000
000110001222100011000
000000000000000000000
000000000000000000000
000000000000000000000
100000005000100000001
110000015000110000011
111000555000111000111
100000000000000000001
100000000000000000001
100000000000000000001
111000111000555000111
110000011000510000011
100000001000500000001
000000000000000000000
000000000000000000000
000000000000000000000
000110001222100011000
000210001222100012000
000210001222100012000
000210001222100012000
000110001222100011000
000000000000000000000
100000000000000000001
100000000000000000001
111000007070700000111