000000004040400111111
000000000000000000111
000000000000000000111
000000000001000000001
000100220011002000001
000122221111102200000
002222222201112220000
000002222001112222200
000000022001133322200
000000022011133322000
000001022000133322000
000001222220000020001
000111222222000020011
000011122000000000001
000000000000555000001
000000000000011100001
000000000000000000000
100001110000000000000
100000555000000000000
100000000000221110000
110020000222222111000
100020000022222100000
000223331000220100000
000223331110220000000
002223331100220000000
002222211100222200000
000022211102222222200
000002201111122221000
100000200110022001000
100000000100000000000
111000000000000000000
111000000000000000000
111111004040400000000