111000004040400000111
1000000000000000000W1
100000000000000000001
000000000000000000000
000022222000222220000
000021111000111120000
000021333000333120000
000221333000333122000
000111333000333111000
000000000000000000000
000000000000000000000
000000000000000000000
000000000000000000000
000021000000001120000
000021000000001120000
000221000000000122000
000111000010000111000
000221000000000122000
000021100000000120000
000021100000000120000
000000000000000000000
000000000000000000000
000000000000000000000
000000000000000000000
000111333000333111000
000221333000333122000
000021333000333120000
000021111000111120000
000022222000222220000
000000000000000000000
100000000000000000001
1W0000000000000000001
111000004040400000111