511555555555555555HH5
515HHHHHHHHHHHHHHHHHH
5HHHHHHHHHHHHHHHHHHHH
5HHHHHHHHHHHHHHHHHHHH
5HHHH2222HHHH2221HHHH
5HHHH1HHHHHHHHHH2HHHH
5HHHH1H55HHHH55H2HHHH
5HHH21H44HHH444H21HHH
5HHHGGH44HHH344GGHHHH
5HHHHHHHHHHHHHHHHHHHH
5HHHHHHHHHHHHHHHHHHHH
5HHHHHHHHHHHHHHHHHHHH
5HHHHHHHHHHHHHHHHHHHH
5HHHH1HHHHHHHHHH2HHHH
5HHH21HHHHHHHHHH2HHHH
5HHHHHHHHHHHHHHHHHHHH
5HHH21HHHHHHHHHH22HHH
5HHHH1HHHHHHHHHH2HHHH
5HHHH1GHHHHHHHHG2HHHH
5HHHHHHHHHHHHHHHHHHHH
5HHHHHHHHHHHHHHHHHHHH
5HHHHHHHHHHHHHHHHHHHH
5HHHHHHHHHHHHHHHHHHHH
5HHH21H44HHH444H21HHH
5HHH11H44HHH444H2HHHH
5HHHH1HHHHHHHHHH2HHHH
5HHHH2222HHH22222HHHH
5HHHHHHHHHHHHHHHHHHHH
5HHHHHHHHHHHHHHHHHHH5
5HHHHHHHHHHHHHHHHHHH1
5GHHHHHH33434HHHHH111
