000000004040400000000
000000000000000000000
000000000000000000000
222000000000000001660
221100001100000001660
220000001111000000000
220000000000000000000
220000000000000000000
220555025111111333311
220000025551111333311
000000022222222200000
000000022222222200000
000000001000000000000
000000000000000000000
000000000000000522000
000000000000000522000
000000000000000000000
000225000000000000000
000225000000000000000
000000000000000000000
000000000000100000000
000002222222220000000
000002222222220000000
113333111155520000022
113333111111520555022
000000000000000000022
000000000000000000022
000000000111100000022
066100000001100001122
066100000000000000222
000000000000000000000
000000000000000000000
000000004040400000000