222222221112122222222
2HHHHHHHHHHHHHHHHHHHH
2HHHHHHHHHHHHHHHHHHHH
2HHHHHHHHHHHHHHHHHHHH
2221HHHHHHHHHHHHH11HH
222HHHHHHHHHHHHHHHHHH
222HHHHHHHHHHHHHHHHHH
222HHHHHHHHHHHHHHHHHH
222H55HH5HHHHHH344HH1
222HHHHH555HHHH4445H1
2HHHHHHH22222222HHHHH
2HHHHHHH12222222HHHHH
2HHHHHHHHHHHHHHHHHHHH
2HHHHHHHHHHHHHH3HHHHH
2HHHHHHHHHHHHHH522HHH
2HHHHHHHHHHHHHHH1HHHH
2HHH25HHHHHHHHHHHHHHH
2HHH22HHHHHHHHHHHHHHH
2HHHHHHHHHHHHHHHHHHHH
2HHHHHHHHHHHHHHHHHHHH
2HHHHH22222222HHHHHHH
2HHHHH11115552HHHHHH1
2HH4443HHHHH52HHHHH22
2GH333HGGGGGH1HHHHH22
2HHHHHHHHHHHHHHHHHH22
2HHHHHHHHHHHHHHHHHH22
2HHHHHHHHHHHHHHHHH122
2H15HHHHHHHHHHHHHH222
2HHHHHHHHHHHHHHHHHHH1
2HHHHHHHHHHHHHHHHHHHH
2HHHHHHH33434HHHHHHHH
