........2.2.2........
.....................
.....................
................MM...
.L...MM...b.....MM...
.....MM...b.....FF...
XXX.......b.....FF...
XX........bbbb..FF...
.............b..FF...
...FFMM......b..MM...
...FFMMMMM...b..MM...
...FFFF......b.......
.............b.......
..........bbbb.......
.....MMF..b.......XXX
.....MMF..b........XX
.....MM...b...MM.....
XX........b..FMM.....
XXX.......b..FMM.....
.......bbbb..........
.......b.............
.......b......FFFF...
...MM..b...MMMMMFF...
...MM..b......MMFF...
...FF..b.............
...FF..bbbb........XX
...FF.....b.......XXX
...FF.....b...MM..K..
...MM.....b...MM.....
...MM................
.....................
.....................
........1.1.1........