.................YY..
.................CY..
....X.....2.2.2......
....MM...............
..b.MM...........NNNN
..b..MFFF...........C
..b..XXFF............
..b........M........F
..b........MF.......F
..bbbb...MMMF.......F
M....b....FFF..M....F
M....b.........M...YY
MMFF.b........TM.....
MMMX.b......MMMM.....
.....b...............
.....b............c.Y
Yc...bbbbbbbbbbb....Y
Y..............b.....
...............b.....
.....MMMM......b.XMMM
.....MT........b.FFMM
YY...M.........b....M
F....M..FFF....b....M
F.......FMMM...bbbb..
F.......FM........b..
F........M........b..
............FFXX..b..
C...........FFFM..b..
NNNN...........MM.b..
...............MM....
......1.1.1.....X....
..YC.................
..YY.................