......2.2.2..WWW..FCY
.............WWW..FFF
.............FWW.....
.............FWW.....
.....NNN.......T.....
.....WWWO............
.....WWW.............
.....WWWYY.........b.
F....FWW......YYY..b.
F.M..FWW....FFWWYC.b.
F.M...WW....FFWW...b.
F.MM...YYC...WWW...b.
F.MM.........WWW.bbb.
F............WWW.b...
..............TT.b.FF
.................b.MM
...bbbbbbbbbbbbbbb...
MM.b.................
FF.b.TT..............
...b.WWW............F
.bbb.WWW.........MM.F
.b...WWW...CYY...MM.F
.b...WWFF....WW...M.F
.b.CYWWFF....WWF..M.F
.b..YYY......WWF....F
.b.........YYWWW.....
...........U.WWW.....
.............WWW.....
.....T.......NNN.....
.....WWF.............
.....WWF.............
FFF..WWW.............
YCF..WWW..1.1.1......