........2.2.2........
...FFF.........FFF...
...FFF.........FFF...
MMMFF....WWW....FFMMM
..MFF...WWWWW...FFM..
...FF...WWWWW...FF...
.....................
...............Y.....
...MMM.bbbbb...MMM...
...M...b...b.....M...
.......b...b.........
....bbbb.M.bbbbb....T
....b....M...........
..M.b...MM.......M...
MMM.b..........MMM...
FFF.b................
....bbbbbbbbbbbbb....
................b.FFF
...MMM..........b.MMM
...M.......MM...b.M..
...........M....b....
T....bbbbb.M.bbbb....
.........b...b.......
...M.....b...b...M...
...MMM...bbbbb.MMM...
.....Y...............
.....................
...FF...WWWWW...FF...
..MFF...WWWWW...FFM..
MMMFF....WWW....FFMMM
...FFF.........FFF...
...FFF.........FFF...
........1.1.1........