FFF.....2.2.2.....FFF
FFF...............FFF
FFFFF...........FFFFF
FFFFFFFF.....FFFFFFFF
FFFFFFFFMMMMYFFFFMMMM
MMFFFFFFFFFFFFFFFFMMM
..FFFFFFFFbbbbbFFFFFF
...FFFFFFFbFFFFFFFFFF
.....FFFFFbFFFFFFFFFF
.......FFFbFFMMMFFFFF
.....TTFFFbFFFFFFFFFF
FF.NNNNNNFbbbbbbbFFFF
FF...YCFFFFFFFFFbFFFF
FFFF.....FFFFFFFbFFMM
FFFFFF......FFFFbFFMM
FFFFFFF.....FFFFbFFFF
FFFFbbbbbbbbbbbbbFFFF
FFFFbFFFF.....FFFFFFF
MMFFbFFFF......FFFFFF
MMFFbFFFFFFF.....FFFF
FFFFbFFFFFFFFFCY...FF
FFFFbbbbbbbFNNNNNN.FF
FFFFFFFFFFbFFFTT.....
FFFFFMMMFFbFFF.......
FFFFFFFFFFbFFFFF.....
FFFFFFFFFFbFFFFFFF...
FFFFFFbbbbbFFFFFFFF..
MMMFFFFFFFFFFFFFFFFMM
MMMMFFFFYMMMMFFFFFFFF
FFFFFFFF.....FFFFFFFF
FFFFF...........FFFFF
FFF...............FFF
FFF.....1.1.1.....FFF