MFFFFFF.2.2.2.FFFFFFM
FFFFFFF.......FFFFFFF
.....................
........IIIII........
.....................
.....................
.....................
.....................
.....................
.....................
.....................
.....................
.....................
.....................
.....................
.....................
.....................
.....................
.....................
.....................
.....................
.....................
.....................
.....................
.....................
.....................
.....................
.....................
.....................
........IIIII........
.....................
FFFFFFF.......FFFFFFF
MFFFFFF.1.1.1.FFFFFFM