WWWWWWWWWWWWWWWWWWWWWWWWWWWWWWWWWWWWWWWWWWWWWWWWWWWWWWWWWWWW
WWWWWWWWWWWWWWWWWWWWWWWWWWWWWWWWWWWWWWWWWWWWWWWWWWWWWWWWWWWW
WWWWWWWWWWWWWWWWWWWWWWWWWWWWWWWWWWWWWWWWWWWWWWWWWWWWWWWWWWWW
WWWWWWWWWWWWWWWWWWWWWWWWWWWWWWWWWWWWWWWWWWWWWWWWWWWWWWWWWWWW
WWWWWWWWWWWWWWWWWWWWWWWWWWWWWWWWWWWWWWWWWWWWWWWWWWWWWWWWWWWW
WWWWWWWWWWWWWWWWWWWWWWWWWWWWWWWWWWWWWWWWWWWWWWWWWWWWWWWWWWWW
WWWWWWWWWWWWWWWWWWWWWWWWWWWWWWWWWWWWWWWWWWWWWWWWWWWWWWWWWWWW
WWWWWWWWWWWWWWWWWWWWWWWWWWWWWWWWWWWWWWWWWWWWWWWWWWWWWWWWWWWW
WWWWWWWWWWWWWWWWWWWWWWWWWWWWWWWWWWWWWWWWWWWWWWWWWWWWWWWWWWWW
WWWWWWWWWWWWWWWB...BWWWWWWWWWWWWWWWWWWWWWWWWWWWWWWWWWWWWWWWW
WWWWWWWWWWWWWWW.....WWWWWWWWWWWWWWWWWWWWWWWWXMMMXWWWWWWWWWWW
WWWWWWWWWWWWWWW.CCC.WWWWWWWWWW...C.T..WWWWWWMFFFMWWWWWWWWWWW
WWWWWWWWWWWWWWWNNNNNWWWWWWWWWW.XNNNNX.WWWWWWMFFFMWWWWWWWWWWW
WWWWWWWWWWWWWWWWWWWWWWWWWWWWWWWWWWWWWWWWWWWWXMMMXWWWWWWWWWWW
WWWWWWWWWWWWWWWWWWWWWWWWWWWWWWWWWWWWWWWWWWWWWWWWWWWWWWWWWWWW
WWWWWWWWWWWWWWWWWWWWWWWWWWWWWWWWWWWWWWWWWWWWWWWWWWWWWWWWWWWW
WWWWWWWWWWWWEEEEEEEEEEEEEEEEEEEEEEEEEEEEEEEEEEEWWWWWWWWWWWWW
WWWWWWWWWWWWED........NNNFF.....FFNNN....D....EWWWWWWWWWWWWW
WWWWWWWWWWWWE.........BBTFF.....FFTBB.........EWWWWWWWWWWWWW
WWWWWWWWWWWWE..3.3.3...................4.4.4..EWWWWWWWWWWWWW
WWWWC..CWWWWE.........D....XIIIX..............EWWWWWWWWWWWWW
WWWW.YY.WWWWE.................................EWWWWWWWWWWWWW
WWWW.YY.WWWWEMX....MMM...............MMM......EWW....WWWWWWW
WWWWC..CWWWWE.........................D.....XMEWW.TT.WWWWWWW
WWWWWWWWWWWWE...............NNN...............EWW....WWWWWWW
WWWWWWWWWWWWE...bbbbbbbbb....T....bbbbbbbbb...EWWWWWWWWWWWWW
WWWWWWWWWWWWE...b.......b.........b.....D.b...EWWWWWWWWWWWWW
WWWWWWWWWWWWE...b.......b.........b.......b...EWWWWWWWWWWWWW
WWWWWWWWWWWWE...b.......b.........b.......b...EWWWWWWWWWWWWW
WWWWWWWWWWWWE...b..YYC..b....8....b..CYY..b.D.EWWWWWWWWWWWWW
WWWWWWWWWWWWE...b.......b.........b.......b...EWWWWWWWWWWWWW
WWWWWWWWWWWWE...b.......b.........b.......b...EWWWWWWWWWWWWW
WWWWWWBNWWWWE...b.D.....b.........b.......b...EWWWWWWWWWWWWW
WWWWWWBNWWWWE...bbbbbbbbb....T....bbbbbbbbb...EWWWWWWWWWWWWW
WWWWWWBNWWWWE.............D.NNN...............EWWWWWWWWWWWWW
WWWWWWBNWWWWE.D...............................EWWWWWYTCWWWWW
WWWWWWBNWWWWEMX....MMM...............MMM....XMEWWWWWTYTWWWWW
WWWWWWWWWWWWE.......................D.......D.EWWWWWCTYWWWWW
WWWWWWWWWWWWE..............XIIIX..............EWWWWWWWWWWWWW
WWWWWWWWWWWWE..1.1.1...................2.2.2..EWWWWWWWWWWWWW
WWWWWWWWWWWWE.........BBTFF..D..FFTBB.........EWWWWWWWWWWWWW
WWWWWWWWWWWWE.D.......NNNFF.....FFNNN.........EWWWWWWWWWWWWW
WWWWWWWWWWWWEEEEEEEEEEEEEEEEEEEEEEEEEEEEEEEEEEEWWWWWWWWWWWWW
WWWWWWWWWWWWWWWWWWWWWWWWWWWWWWWWWWWWWWWWWWWWWWWWWWWWWWWWWWWW
WWWWWWWWWWWWWWWWWWWWWWWWWWWWWWWWWWWWWWWWWWWWWWWWWWWWWWWWWWWW
WWW..TTWWWWWWWWWWWWWWWWWWWWWWWWNNCNWWWWWWWWWWW....WWWWWWWWWW
WWW.DTTWWWWWWWWWWWWWWWWWWWWWWWW.T..WWWWWWWWWWW.XX.WWWWWWWWWW
WWW....WWWWWWWWWWWWWWWWWWWWWWWW....WWWWWWWWWWW.XX.WWWWWWWWWW
WWW..D.WWWWWWWWWWX..XWWWWWWWWWWWWWWWWWWWWWWWWW....WWWWWWWWWW
WWWWWWWWWWWWWWWWW.BB.WWWWWWWWWWWWWWWWWWWWWWWWWWWWWWWWWWWWWWW
WWWWWWWWWWWWWWWWW.BB.WWWWWWWWWWWWWWWWWWWWWWWWWWWWWWWWWWWWWWW
WWWWWWWWWWWWWWWWWX..XWWWWWWWWWWWWWWWWWWWWWWWWWWWWWWWWWWWWWWW
WWWWWWWWWWWWWWWWWWWWWWWWWWWWWWWWWWWWWWWWWWWWWWWWWWWWWWWWWWWW
WWWWWWWWWWWWWWWWWWWWWWWWWWWWWWWWWWWWWWWWWWWWWWWWWWWWWWWWWWWW
WWWWWWWWWWWWWWWWWWWWWWWWWWWWWWWWWWWWWWWWWWWWWWWWWWWWWWWWWWWW
WWWWWWWWWWWWWWWWWWWWWWWWWWWWWWWWWWWWWWWWWWWWWWWWWWWWWWWWWWWW
WWWWWWWWWWWWWWWWWWWWWWWWWWWWWWWWWWWWWWWWWWWWWWWWWWWWWWWWWWWW
WWWWWWWWWWWWWWWWWWWWWWWWWWWWWWWWWWWWWWWWWWWWWWWWWWWWWWWWWWWW
WWWWWWWWWWWWWWWWWWWWWWWWWWWWWWWWWWWWWWWWWWWWWWWWWWWWWWWWWWWW
WWWWWWWWWWWWWWWWWWWWWWWWWWWWWWWWWWWWWWWWWWWWWWWWWWWWWWWWWWWW