FFFFFFFFFFFFFFFFFFFFFFFFFFFFFFFFFFFFFFFFFFFFFFFFFFFFFFFFFFFF
FFFFFFFFFFFFFFFFFFFFFFFFFFFFFFFFFFFFFFFFFFFFFFFFFFFFFFFFFFFF
FFFFFFFFFFFFFFFFFFFFFFFFFFFFFFFFFFFFFFFFFFFFFFFFFFFFFFFFFFFF
FFFFFFFFFFFFFFFFFFFFFFFFFFFFFFFFFFFFFFFFFFFFFFFFFFFFFFFFFFFF
FFFFFFFFFFFFFFFFFFFFFFFFFFFFFFFFFFFFFFFFFFFFFFFFFFFFFFFFFFFF
FFFFFFFFFFFFFFFFFFFFFFFFFFFFFFFFFFFFFFFFFFFFFFFFFFFFFFFFFFFF
FFFFFFaaaaaaaaaaaaaaaaaaaaaaaaaaaaaaaaaaaaaaaaaaaaaaaaFFFFFF
FFFFFFaWWWWWWWWWWWWWWWWWWWWWWWWWWWWWWWWWWWWWWWWWWWWWWaFFFFFF
FFFFFFaWWWWWWWWWWWWWWWWWWWWWWWWWWWWWWWWWWWWWWWWWWWWWWaFFFFFF
FFFFFFaWWWWWWWWWWWWWWWWWWWWWWWWWWWWWWWWWWWWWWWWWWWWWWaFFFFFF
FFFFFFaWWWEEEEEEEEEEEEEEEEEEEEEEEEEEEEEEEEEEEEEEEEWWWaFFFFFF
FFFFFFaWWWEFFFFFFFFFFFFFFFFFFFFFFFFFFFFFFFFFFFFFFEWWWaFFFFFF
FFFFFFaWWWEF...D................................FEWWWaFFFFFF
FFFFFFaWWWEF........BB...C.......C....BB......D.FEWWWaFFFFFF
FFFFFFaWWWEF........BB.1.YY..1..YY.1..BB........FEWWWaFFFFFF
FFFFFFaWWWEF.D..................................FEWWWaFFFFFF
FFFFFFaWWWEF.....1.....8..D..8.....8...D..1..D..FEWWWaFFFFFF
FFFFFFaWWWEF........D............D..............FEWWWaFFFFFF
FFFFFFaWWWEF.MM..............................MM.FEWWWaFFFFFF
FFFFFFaWWWEF.MM..8..bbbbbbbbbbbbbbbbbbbb..8..MM.FEWWWaFFFFFF
FFFFFFaWWWEF........b......D...........b........FEWWWaFFFFFF
FFFFFFaWWWEF........b..MM..........MM..b........FEWWWaFFFFFF
FFFFFFaWWWEF........b..MFFFFFMMFFFFFM..b........FEWWWaFFFFFF
FFFFFFaWWWEFFFFFFMM.b..MFFFFFMMFFFFFM..b.MMFFFFFFEWWWaFFFFFF
FFFFFFaWWWEFFFFFFMM.b..................b.MMFFFFFFEWWWaFFFFFF
FFFFFFaWWWE.........bbbbbbbbbbbbbbbbbbbb.........EWWWaFFFFFF
FFFMMMMWWWED....................................DEWWWMMMMFFF
FFFMMMMWWWEaaa.........aaa....D...aaa.........aaaEWWWMMMMFFF
FFFWWWWWWWEWWW...g....WWWWW.FFFF.WWWWW....D...WWWEWWWWWWWFFF
FFFWWWWWWWEWWWW.....TWWWWWWWFFFFWWWWWWWT.....WWWWEWWWWWWWFFF
FFFWWWWWWWEWWWWT.....WWWWWWWFFFFWWWWWWW.....TWWWWEWWWWWWWFFF
FFFWWWWWWWEWWW........WWWWW.FFFF.WWWWW....g...WWWEWWWWWWWFFF
FFFXXXXWWWEaaa...D.....aaa........aaa.........aaaEWWWXXXXFFF
FFFXXXXWWWED................D...................DEWWWXXXXFFF
FFFFFFaWWWE....bbbbbbbbbbbbbbbbbbbbbbbbbbbbbb....EWWWaFFFFFF
FFFFFFaWWWEFFF.b............................b.FFFEWWWaFFFFFF
FFFFFFaWWWEFFF.b.......XFFFFFXXFFFFFX.......b.FFFEWWWaFFFFFF
FFFFFFaWWWEF...b..NNN..XFFFFFXXFFFFFX..NNN..b...FEWWWaFFFFFF
FFFFFFaWWWEF...b.......XX..........XX.......b...FEWWWaFFFFFF
FFFFFFaWWWEF...b...............D............b...FEWWWaFFFFFF
FFFFFFaWWWEF...b..8..bbbbbbbbbbbbbbbbbb..8..b...FEWWWaFFFFFF
FFFFFFaWWWEF...b.....b................b.....b...FEWWWaFFFFFF
FFFFFFaWWWEF...b...D.b...........D....b.....b...FEWWWaFFFFFF
FFFFFFaWWWEF.D.bbbbbbb..8.D...8....8..bbbbbbb...FEWWWaFFFFFF
FFFFFFaWWWEF..................................D.FEWWWaFFFFFF
FFFFFFaWWWEF.....1..BB..1.YY..1..YY.1.BB..1.....FEWWWaFFFFFF
FFFFFFaWWWEF........BB....C.......C...BB........FEWWWaFFFFFF
FFFFFFaWWWEF....................................FEWWWaFFFFFF
FFFFFFaWWWEFFFFFFFFFFFFFFFFFFFFFFFFFFFFFFFFFFFFFFEWWWaFFFFFF
FFFFFFaWWWEEEEEEEEEEEEEEEEEEEEEEEEEEEEEEEEEEEEEEEEWWWaFFFFFF
FFFFFFaWWWWWWWWWWWWWWWWWWWWWWWWWWWWWWWWWWWWWWWWWWWWWWaFFFFFF
FFFFFFaWWWWWWWWWWWWWWWWWWWWWWWWWWWWWWWWWWWWWWWWWWWWWWaFFFFFF
FFFFFFaWWWWWWWWWWWWWWWWWWWWWWWWWWWWWWWWWWWWWWWWWWWWWWaFFFFFF
FFFFFFaaaaaaaaaaaaaaaaaaaaaaaaaaaaaaaaaaaaaaaaaaaaaaaaFFFFFF
FFFFFFFFFFFFFFFFFFFFFFFFFFFFFFFFFFFFFFFFFFFFFFFFFFFFFFFFFFFF
FFFFFFFFFFFFFFFFFFFFFFFFFFFFFFFFFFFFFFFFFFFFFFFFFFFFFFFFFFFF
FFFFFFFFFFFFFFFFFFFFFFFFFFFFFFFFFFFFFFFFFFFFFFFFFFFFFFFFFFFF
FFFFFFFFFFFFFFFFFFFFFFFFFFFFFFFFFFFFFFFFFFFFFFFFFFFFFFFFFFFF
FFFFFFFFFFFFFFFFFFFFFFFFFFFFFFFFFFFFFFFFFFFFFFFFFFFFFFFFFFFF
FFFFFFFFFFFFFFFFFFFFFFFFFFFFFFFFFFFFFFFFFFFFFFFFFFFFFFFFFFFF