FFFFFFFFFFFFFFFFFYYYYFFFFFFFFFFFFFFFFFFFFFFFFFFFYYFFFFFFFFFF
FFFFFFFFFFFFFFFFFYYYYFFFFFFFFFFFFFFFFFFFFFFFFFFFYYFFFFFFFFFF
FFFFFFFFCFFFFFFFFYYYYFFFFFFFFFFFFFFFFFFFFFFFFFFFYYFFFFFFFFFF
FFFFFFFFFFFFFFFFFFFFFFFFFFFFFFFFFFFFFFFFFFFFFFFFFFFFTFFFFFFF
FFFFFFFFFFFFFFFFFFFFFFFFFFFCFFFFFYYYFFFFFFFFFFFFFFFFFFFYYFFF
YYFFFFFFFFFYYFFFFFFFFFFFFFFFFFFFFYYYFFFFFCCFFFFFFFFFFFFYYYFF
YYFFFFFFFFFYYFFFFFFFFFFFFFFFFFFFFFFFFFFFFFFFFFFFFFFFFFFFYYFF
FFFFFFFFFFFYYFFFFFFFFFFFFFTFFFFFFFFFFFFFFFFFFFFFFFFFFFFFFFFF
FFFFFFFFFFFFFFFFFFFFCCFFFFFFFFFFFFFFFFFFFFFFFFFFFFCFFFFFFFFF
FFFFFCFFFFFFFFFFFFFFFFFFFFFFFFFFFFFFFFFFFFFFFFFFFFFFFFFFFFFF
FFFFFFFFFFFFFFFFFFFFFFFFFFFFFFFCCFFFFFFFFFFFFFFFFFFFFFFFFFFF
FFFFFFFFTFFFFCFFFFFFFFFYYFFFFFFFFFFFFFFFYYYFFFFFFFFFFFFFYFFF
FFFFFF...........FF................F............F.....FFFFFF
FFF......................................................FFF
FF.......EEEEEEEEEEEEEEEEEEEEEEEEEEEEEEEEEEEEEEEEEE.......FF
F.....EEEEFFFFFFFFFFFFFFFFFFFFFFFFFFFFFFFFFFFFFFFFEEEE.....F
..F..EEFFFFFFFFFFFFFFFFFFFFFFFFFFFFFFFFFFFFFFFFFFFFFFEE....F
....EEFFFFFFFFFFFFFFFFFFFFFFFFFFFFFFFFFFFFFFFFFFFFFFFFEE..F.
F...EFF...MM....D........MM......XX.......DD....XX...FFE....
....EFF...FF.............FF......FF.............FF...FFE....
...EEFF..bbbbbbbbbbb.MF.bbbb....bbbb..BB.bbbbbbbbbb..FFEE...
.F.EFFF..b.........b.MF.b..b....b..b.XXX.b........b..FFFE.F.
...EFFFMFb..FF.....b.MF.b..b.B..b..b.BBB.b....FF..bFXFFFE...
.F.EFFFMFb..MM.1...b....b..bFMXFb..b.....b....XX..bFXFFFE...
...EFFFMFb..FF.....bbbbbb..bFMXFb..bbbbbbb..1.FF..bFXFFFE...
...EFFFMFb.................b..B.b.................bFXFFFE...
...EFF...bbb.1.............b....b...............bbb...FFE...
...EFF.....b...FFF..8......b....b......8..FFF.1.b.....FFE..F
...EFF.....b...MMM.....FMF.bD...b.FXF.....XXX...b.....FFE..F
...EFF.....b.1.FFF.....FMF.b.gD.b.FXF.....FFF...b.....FFE...
...EFF.....b...FFF.....FMF.b....b.FXF.....FFF.1.b.....FFE...
...EFF.....b...MMM.....FMF.b..D.b.FXF.....XXX...b.....FFE...
.F.EFF...bbb.1.FFF..8......b....b......8..FFF...bbb...FFE.F.
.F.EFF...b.................b....b.............1...b...FFE.F.
...EFFFMFb.................b.B..b.................bFXFFFE...
...EFFFMFb..FF.1..bbbbbbb..bFMXFb..bbbbbb.....FF..bFXFFFE...
...EFFFMFb..MM....b.....b..bFMXFb..b....b...1.XX..bFXFFFE...
F..EFFFMFb..FF....b.BBB.b..b..B.b..b.FX.b.....FF..bFXFFFE...
...EFFF..b........b.MMM.b..b....b..b.FX.b.........b..FFFE...
...EEFF..bbbbbbbbbb.BB..bbbb....bbbb.FX.bbbbbbbbbbb..FFEE...
....EFF...FF.............FF......FF.............FF...FFE....
..F.EFF...MM..D..........MM......XX.............XX...FFE....
....EEFFFFFFFFFFFFFFFFFFFFFFFFFFFFFFFFFFFFFFFFFFFFFFFFEE....
.F...EEFFFFFFFFFFFFFFFFFFFFFFFFFFFFFFFFFFFFFFFFFFFFFFEE...F.
F.....EEEEFFFFFFFFFFFFFFFFFFFFFFFFFFFFFFFFFFFFFFFFEEEE.....F
FF.......EEEEEEEEEEEEEEEEEEEEEEEEEEEEEEEEEEEEEEEEEE.......FF
FFF......................................................FFF
FFFFF..F.........F......FF....................F......F.FFFFF
FFFFFFFFFFFFYYYFFFFFFFFFFFFFFFYYFFFFFCFFFFFFFFFFFFFFFFFFFFFF
FFFFFCFFFFFFFFFFFFFFFFFCFFFFFFFFFFFFFFFFFFFFFFFFFFFFFFTFFFFF
FFFFFFFFFFFFFFFFFFFFFFFFFFFFFFFFFFFTFFFFFFFFFFFFFFFFFFFFFFFF
FFFFFFFFFFFFFFFFFFFFFFFFFFFFFFFFFFFFFFFFFFCFFFFFYYYFFFFFFFFF
FFFFFFFFFFFFFFFCCFFFFFFFYYFFFFFCFFFFFFFFFFFFFFFFYYYFFFFFFFFF
FFFFFFFFFFFFFFFFFFFFFFFFYYFFFFFFFFFFFFFFFFFFFFFFYYYFFFFFFFFF
FFFFFYYYFFFFFFFFFFFFFFFFYYFFFFFFFFFFFFFFFFFFTFFFFFFFFFFFFFFF
FFFFFYYYFFFFFFFFFFFFFFFFFFFFFFFFFFFFFFFFFFFFFFFFFFFFFFFFFFFF
FFFFFFFFFFFFFFFFFFFFFFFFFFFFFFFFFFFFFFFFFFFFFFFFFFFFFFFFFFFF
FFFFFFFFFFFFFFFFFFFFFFFFFFFFFFFFFFFFFFFFFFFFFFFFFFFFFFF.YYYY
FFFFFFFFFFFFFFFFFFFFFFFFFFFFFFFFFFYYYYFFFFFFFFFFFFFFFFFFYYYY
FFFFFFFFFFFFFFFFFFFFFFFFFFFFFFFFFFYYYYFFFFFFFFFFFFFFFFFFYYYY