............................................................
............................................................
..FFFFFFMMFFFFFFMMFFFFFFMMFFFFFFMMFFFFFFMMFFFFFFMMFFFFFFMM..
..FFFFFFMMFFFFFFMMFFFFFFMMFFFFFFMMFFFFFFMMFFFFFFMMFFFFFFMM..
..FFMMFFFFFFMMFFFFFFMMFFFFFFMMFFFFFFMMFFFFFFMMFFFFFFMMFFFF..
..FFMMFFFFFFMMFFFFFFMMFFFFFFMMFFFFFFMMFFFFFFMMFFFFFFMMFFFF..
..FFFFEEEEEEEEEEEEEEEEEEEEEEEEEEEEEEEEEEEEEEEEEEEEEEEEFFFF..
..FFFFENNNNNNNNNNY.....MMy........MM....BBYNNNNNNNNNNEFFFF..
..FFFFEN....D..........MM........DMM................NEFFMM..
..FFFFEN............wwwww.........wwwww...wwwwwwww..NEFFMM..
..MMFFEN............wwwww.........wwwww...wwwwwwww.DNEFFFF..
..MMFFEN...................>.8...........D......ww..NEFFFF..
..FFFFEND...8...................................ww..NEMMFF..
..FFFFEN........NNNN..............MMFFFMMMFFMM..ww..NEMMFF..
..FFMMEN....>...NTD...............FFFFFFFFFFFF......NEFFFF..
..FFMMEN........N.......>...................FF......NEFFFF..
..FFFFEN.......DN...........................FF..ww..NEFFMM..
..FFFFEY........N...........NNNN.....8......FM..ww..YEFFMM..
..MMFFE.....YYFFFFFFFFFwwwwwwwww............FM..ww...EFFFF..
..MMFFED....YYFFFFFFFFFwwwwwwwww.....>......FM..ww...EFFFF..
..FFFFE.....BB.....FFFFwwNNNNNNN.....................EMMFF..
..FFFFE............FMMFwwNWWWWWFFFFM....BB...........EMMFF..
..FFMME........>...FMMFwwNWWWWWFFFFM...YY............EFFFF..
..FFMME.....8......FFFFww.WWWWWD.......NFFFF..>..FFFFEFFFF..
..FFFFE............wwwwww.WWWy........DNFFFF....DFFFFEFFMM..
..FFFFE............wwwwww.WWW..........NFF.........FFEFFMM..
..MMFFE..........g........WWWWWL.L.L.L.NFF.........FFEFFFF..
..MMFFEBB......Y........D.WWWWW........NFF....8....FFEFFFF..
..FFFFEaaaaaaaYY..........WWWWWYYYYYYYYNFF.........FFEMMFF..
..FFFFEWWWWWWMMMFFFFFFFMMMWWWWWIIIIIIIIN.............EMMFF..
..FFXXEWWWWWWXXXFFNNNFFXXXWWWWWIIIIIIIIN.............EFFFF..
..FFXXEaaaaaaa.D..YYY..........NNNNNNNNN.1.1.1.1.1.1.EFFFF..
..FFFFEBB.........CCC...........D...TYYY..1.1...1.1..EFFXX..
..FFFFE...............................YY...D.....D...EFFXX..
..XXFFE..........................8.>..FYFFNNN...NNNFFEFFFF..
..XXFFE....8.>...........CC...........FFFFFYY...YYFFFEFFFF..
..FFFFE.........T..D...BBYY..........................EXXFF..
..FFFFE.........NNNN...NNNN.....YY...................EXXFF..
..FFXXE.........wwwwwwwwwwwwwwwwaaaa..........>......EFFFF..
..FFXXE.........wwwwwwwwwwwwwwwwWWWW............D....EFFFF..
..FFFFEYBBXFFXD.wwXXFFFXXFFFXXwwWWWW................YEFFXX..
..FFFFENBBXFFX..wwXXFFFXXFFFXXwwWWWW.g..FFXB...YYFFFNEFFXX..
..XXFFEN........wwwwwwwwwwwwwwwwWWWW....FFXB...YYFFFNEFFFF..
..XXFFEN........wwwwwwwwwwwwwwwwaaaa....FF..........NEFFFF..
..FFFFEN...>....NNNND..NNNN.............FF..........NEXXFF..
..FFFFEN........T........BB.............FFX...>.....NEXXFF..
..FFXXEN...8.................>...8...>..FFX.........NEFFFF..
..FFXXEND...............................FF....8.....NEFFFF..
..FFFFEN................................FF...D....BBNEFFXX..
..FFFFEN.......D..FFXXXFF...........y.XXFFC.......BBNEFFXX..
..XXFFENNNNNNNNNNYFFXXXFF..D...D......XXFFYNNNNNNNNNNEFFFF..
..XXFFEEEEEEEEEEEEEEEEEEEEEEEEEEEEEEEEEEEEEEEEEEEEEEEEFFFF..
..FFFFXXFFFFFFXXFFFFFFXXFFFFFFXXFFFFFFXXFFFFFFXXFFFFFFXXFF..
..FFFFXXFFFFFFXXFFFFFFXXFFFFFFXXFFFFFFXXFFFFFFXXFFFFFFXXFF..
..XXFFFFFFXXFFFFFFXXFFFFFFXXFFFFFFXXFFFFFFXXFFFFFFXXFFFFFF..
..XXFFFFFFXXFFFFFFXXFFFFFFXXFFFFFFXXFFFFFFXXFFFFFFXXFFFFFF..
............................................................
............................................................
............................................................
............................................................