WWWWWWWWWWWWWWWWWWWWWWWWWWWWWWWWWWWWWWWWWWWWWWWWWWWWWWWWWWWW
WWWWWWWWWWWWWWWWWWWWWWWWWWWWWWWWWWWWWWWWWWWWWWWWWWWWWWWWWWWW
WWWWWWWWWWWWWWWWWWWWWWWWWWWWWWWWWWWWWWWWWWWWWWWWWWWWWWWWWWWW
WWWWWWWWWWWWWWWWWWWWWWWWWWWWWWWWWWWWWWWWWWWWWWWWWWWWWWWWWWWW
WWWWWWWWWWWWWWWWWWWWWWWWWWWWWWWWWWWWWWWWWWWWWWWWWWWWWWWWWWWW
WWWWWWWWWWWWWWWWWWWWWWWWWWWWWWWWWWWWWWWWWWWWWWWWWWWWWWWWWWWW
WWWWMWWWWËWWWWWMWWWWWWWWÊWWWWWWWWWWWWWWWWWWWWWWWWWWWWWWWWWWW
WWWWMWWWWWWWWWWMWWWWWWWWWWWWWWWWWWWWWWWWÊWWWWWWWWWWWWWWWWWWW
WWWWMXXWWWWWWXXMWWWWWWWWWWWWWWWWWWWWWWWWWWWWWWWWWWWWWWWWWWWW
WWWWMMMMMMMMMMMMNNNNNNWWWWWWWWWWWWWWWWWWWWWWWWWWWWWWWWWWWWWW
WWWWXXXXXMMMMMMMXXXXXXWWWWFFFFWWWWWWWWWWWWWWWWWWWWWWWWWWWWWW
WWWWEEEEEEEEEEEEEEEEEEEEEEEEFFFFFFFFWWWWWWWWWWWWWWWWWWWWWWWW
WWWWEXXXX..................EFFFFFFTFWWWWWWWWWWWWWWWWWWWWWWWW
WWWWEMM..........FFFF.....DEFTFFFFFFFFFFWWWWWWWWWWWWWWWWWWWW
WWWWEM.D.....FFFFFFF.......EEEEEEEEEEEEEWWWWWWWWWWÊWWWWWWWWW
WWWWEM....FFFFFFFFFF.CCC...............EWWWWWWWWWWWWWWWWWWWW
WWWWE.....FFNNFF......e................EWWWWWWWWWWWWWWWWWWWW
WWWWE........NNN...........FFFFF.......EEEEEEEWWWWWWWWWWWWWW
WWWWE......2................MMMMCC...........EWWWWWWWWWWWWWW
WWWWEX...........D...........DMMXX.......e...EWWWWWWWWWWWWWW
WWWWEMM..........NNN..2.........XXXX.........EWWWWWWWWWWWWWW
WWWWE....FF..D.....NN....................CC..EEEEEEEEWWWWWWW
WWWWE....FFFFFF................2...............FFFFFEWWWWWWW
WWWWEMMM.FFFFFFFFF.......TT.........FF.........FFFFFEWWWWWWW
WWWWEMMMMXXFFFFFFFFFF.FF...........NNN..2...........EWWWWWWW
WWWWEMMXXXXFFFFFFFFFF.FFFFFF.D......D...............EWWWWWWW
WWWWEM...FFFFFFTTWWWD...FFFFFFFF.................2..EWWWWWWW
WWWWE......FFFFFFWWW....FFFFFFFFFFFF......NN........EWWWWWWW
WWWWE......FFFFFFWWW...WWWFFFFFFFFFFFFF....NNN......EEEEWWWW
WWWWE.......D..FFFFF...WWWFFFFFFTTWWWFF.FF.............EWWWW
WWWWE.............FF.FFWWWTTFFFFFFWWW...FFFFF..D.......EWWWW
WWWWEEEE......NNN....FFFFFFFFFFFFFWWW...WWWFFFFFF......EWWWW
WWWWWWWE........NN......FFFFFFFFFFFF....WWWFFFFFF......EWWWW
WWWWWWWE..1.................FFFFFFFF...DWWWTTFFFFFF...MEWWWW
WWWWWWWE...............D......D.FFFFFF.FFFFFFFFFFXXXXMMEWWWW
WWWWWWWE...........1..NNN...........FF.FFFFFFFFFFXXMMMMEWWWW
WWWWWWWEFFFFF.........FF.........TT.......FFFFFFFFF.MMMEWWWW
WWWWWWWEFFFFF...............1................FFFFFF....EWWWW
WWWWWWWEEEEEEEE..CC....................NN.....D..FF....EWWWW
WWWWWWWWWWWWWWE..c......XXXX.........1..NNN..........MMEWWWW
WWWWWWWWWWWWWWE...........XXMMD...........D...........XEWWWW
WWWWWWWWWWWWWWE...........CCMMMM................1......EWWWW
WWWWWWWWWWWWWWEEEEEEE.......FFFFF...c.......NNN........EWWWW
WWWWWWWWWWWWWWWWWWWWE.......................FFNNFF.....EWWWW
WWWWWWWWWWWWWWWWWWWWE...............CCC.FFFFFFFFFF....MEWWWW
WWWWWWWWWÊWWWWWWWWWWEEEEEEEEEEEEE.......FFFFFFF.....D.MEWWWW
WWWWWWWWWWWWWWWWWWWWFFFFFFFFFFTFED.....FFFF..........MMEWWWW
WWWWWWWWWWWWWWWWWWWWWWWWFTFFFFFFE..................XXXXEWWWW
WWWWWWWWWWWWWWWWWWWWWWWWFFFFFFFFEEEEEEEEEEEEEEEEEEEEEEEEWWWW
WWWWWWWWWWWWWWWWWWWWWWWWWWWWWWFFFFWWWWXXXXXXMMMMMMMXXXXXWWWW
WWWWWWWWWWWWWWWWWWWWWWWWWWWWWWWWWWWWWWNNNNNNMMMMMMMMMMMMWWWW
WWWWWWWWWWWWWWWWWWWWWWWWWWWWWWWWWWWWWWWWWWWWMXXWWWWWWXXMWWWW
WWWWWWWWWWWWWWWWWWWÊWWWWWWWWWWWWWWWWWWWWWWWWMWWWWWWWWWWMWWWW
WWWWWWWWWWWWWWWWWWWWWWWWWWWWWWWWWWWÊWWWWWWWWMWWWWWËWWWWMWWWW
WWWWWWWWWWWWWWWWWWWWWWWWWWWWWWWWWWWWWWWWWWWWWWWWWWWWWWWWWWWW
WWWWWWWWWWWWWWWWWWWWWWWWWWWWWWWWWWWWWWWWWWWWWWWWWWWWWWWWWWWW
WWWWWWWWWWWWWWWWWWWWWWWWWWWWWWWWWWWWWWWWWWWWWWWWWWWWWWWWWWWW
WWWWWWWWWWWWWWWWWWWWWWWWWWWWWWWWWWWWWWWWWWWWWWWWWWWWWWWWWWWW
WWWWWWWWWWWWWWWWWWWWWWWWWWWWWWWWWWWWWWWWWWWWWWWWWWWWWWWWWWWW
WWWWWWWWWWWWWWWWWWWWWWWWWWWWWWWWWWWWWWWWWWWWWWWWWWWWWWWWWWWW