WWWWWWWWWWWWWWWWWWWWWWWWWWWWWWWWWWWWWWWWWWWWWWWWWWWWWWWWWWWW
WWWWWWWWWWWWWWWWWWWWWWWWWWWWWWWWWWWWWWWWWWWWWWWWWWWWWWWWWWWW
WWWWWWWWWWWWWWWWWWWWWWWWWWWWWWWWWWWWWWWWWWWWWWWWWWWWWWWWWWWW
WWWWWWWWWWWWWWWWWWWWWWWFFWWWWWWWWFFTWWWWWWWWWWWWWWWWWWWWWWWW
WWWWWWWWWWWWWWWWWWWWWWWFFTWWWWWWWFFFWWWWWWWWWWWWWWWWWWWWWWWW
WWWWWWWWWWWWWWWWWWWWWWWWWWWWWWWWWTFFWWWWWWWWWWWWWWWWWWWWWWWW
WWWWWWWWWWWWWWWWWWWWWWWWWWWWWWWWWWWWWWWWWWWWWYFFWWWWWWWWWWWW
WWWWWWWWWWWWWWWWWWWWWWWWWWWWWWWWWWWWWWWWWWWWFB.FFWWWWWWWWWWW
WWWWWWWWWWWWFFFWWWWWWEEEEEEEEEEEEEEEEEEWWWWWFFFTFWWWWWWWWWWW
WWWWWWWWWWWFF.BFWWWWEE................EEWWWWW...WWWWWWWWWWWW
WWWWWWWWWWWF.CTFWWWWE.................FEWWWWWWWWWWWWWWWWWWWW
WWWWWWWWWWWWFFFWWWWEE..2..2..2..2..2..FEEWWWWWWWWWWWWWWWWWWW
WWWWWWWWWWWWWWWWWWWEYY................FFEWWWWWWWWWWWWWWWWWWW
WWWWWWWWWWWWWWWWWWEEYY................FFEEWWWWWWWWWWWWWWWWWW
WWWWWWWWWWWWWWWWWWECYYFFFFC...........FFCEWWWWWWWWWWWWWWWWWW
WWWWWWWWWWWWWWWWWWECFFFFFFC...........FFCEWWWWWWWWWWWWWWWWWW
WWWWWWWWWWWWWWWWEEE.....................CEEEWWWWWWWWWWWWWWWW
WWWWWWWWWWWWWWWWE..........................EWWWWWWWWWWWWWWWW
WWWWWWWWWWWWWWWWE...............FFFFFF.....EWWWWWWWWWWWWWWWW
WWWWWWWWWWWWWWEEE.....FFFCC.....FFFFFF.....EEEWWWWWWWWWWWWWW
WWWWWWWWWWWWEEENNNCFFFFFFNNNN...FFNNNT.......EEEWWWWWWWWWWWW
WWWWWWWWWWWWEF.....FF.........................FEWWWWWWWWWWWW
WWWWWWWWWWWEEF................................FEEWWWWWWWWWWW
WWWWWWWWWWWEFF..c................FFFFFCCFF....FFEWWWWWWWWWWW
WWWWWWWWWWWEFF............FFF....FFWWWWWFFFF..FFEWWWWWWWWWWW
WWWWWWWWWWWEFF..NNN...FFFFFFF....FFWWWWWFFCC..FFEWWWWWWWWWWW
WWWWWWWWWWWEFF..FF....FFWWWWC.................FFEWWWWWWWWWWW
WWWWWWWWWWWE....FF....FFWWWWC...................EWWWWWWWWWWW
WWWWWWWWWWWE....FF..............................EWWWWWWWWWWW
WWWWWWWWWWWET...YF...............TaaaaaT..FY...TEWWWWWWWWWWW
WWWWWWWWWWWET...YF..TaaaaaT...............FY...TEWWWWWWWWWWW
WWWWWWWWWWWE..............................FF....EWWWWWWWWWWW
WWWWWWWWWWWE...................CWWWWFF....FF....EWWWWWWWWWWW
WWWWWWWWWWWEFF.................CWWWWFF....FF..FFEWWWWWWWWWWW
WWWWWWWWWWWEFF..CCFFWWWWWFF....FFFFFFF...NNN..FFEWWWWWWWWWWW
WWWWWWWWWWWEFF..FFFFWWWWWFF....FFF........c...FFEWWWWWWWWWWW
WWWWWWWWWWWEFF....FFCCFFFFF...................FFEWWWWWWWWWWW
WWWWWWWWWWWEEF................................FEEWWWWWWWWWWW
WWWWWWWWWWWWEF.........................FF.....FEWWWWWWWWWWWW
WWWWWWWWWWWWEEE.......TNNNFF...NNNNFFFFFFCNNNEEEWWWWWWWWWWWW
WWWWWWWWWWWWWWEEE.....FFFFFF.....CCFFF.....EEEWWWWWWWWWWWWWW
WWWWWWWWWWWWWWWWE.....FFFFFF...............EWWWWWWWWWWWWWWWW
WWWWWWWWWWWWWWWWE..........................EWWWWWWWWWWWWWWWW
WWWWWWWWWWWWWWWWEEEC.....................EEEWWWWWWWWWWWWWWWW
WWWWWWWWWWWWWWWWWWECFF...........CFFFFFFCEWWWWWWWWWWWWWWWWWW
WWWWWWWWWWWWWWWWWWECFF...........CFFFFYYCEWWWWWWWWWWWWWWWWWW
WWWWWWWWWWWWWWWWWWEEFF................YYEEWWWWWWWWWWWWWWWWWW
WWWWWWWWWWWWWWWWWWWEFF................YYEWWWWWWWWWWWWWWWWWWW
WWWWWWWWWWWWWWWWWWWEEF..1..1..1..1..1..EEWWWWFFFWWWWWWWWWWWW
WWWWWWWWWWWWWWWWWWWWEF.................EWWWWFTB.FWWWWWWWWWWW
WWWWWWWWWWWW...WWWWWEE................EEWWWWF..FFWWWWWWWWWWW
WWWWWWWWWWWFTFFFWWWWWEEEEEEEEEEEEEEEEEEWWWWWWFFFWWWWWWWWWWWW
WWWWWWWWWWWFF.XXWWWWWWWWWWWWWWWWWWWWWWWWWWWWWWWWWWWWWWWWWWWW
WWWWWWWWWWWWFFXXWWWWWWWWWWWWWWWWWWWWWWWWWWWWWWWWWWWWWWWWWWWW
WWWWWWWWWWWWWWWWWWWWWWWWFFTWWWWWWWWWWWWWWWWWWWWWWWWWWWWWWWWW
WWWWWWWWWWWWWWWWWWWWWWWWFFFWWWWWWWTFFWWWWWWWWWWWWWWWWWWWWWWW
WWWWWWWWWWWWWWWWWWWWWWWWTFFWWWWWWWWFFWWWWWWWWWWWWWWWWWWWWWWW
WWWWWWWWWWWWWWWWWWWWWWWWWWWWWWWWWWWWWWWWWWWWWWWWWWWWWWWWWWWW
WWWWWWWWWWWWWWWWWWWWWWWWWWWWWWWWWWWWWWWWWWWWWWWWWWWWWWWWWWWW
WWWWWWWWWWWWWWWWWWWWWWWWWWWWWWWWWWWWWWWWWWWWWWWWWWWWWWWWWWWW