WWWWWWWWWWWWWWWWWWWWWWWWWWWWWWWWWWWWWWWWWWWWWWWWWWWWWWWWWWWW
WWWWWWWWWWWWWWWWWWWWWWWWWWWWWWWWWWWWWWWWWWWWWWWWWWWWWWWWWWWW
WWWW...................................................WWWWW
WWWW.......................DD.DDD......................WWWWW
WWWW................D........D....D....................WWWWW
WWWW...NNNNNNNNNNNNNNNNNNNNNNNNNNNNNNNNNNNNNNNNNNNNN...WWWWW
WWWW...NWWWWWWWWWWWWWWWWWWWWWWWWWWWWWWWWWWWWWWWWWWWN...WWWWW
WWWWD..NWWWWWWWWWWWWWWWWWWWWWWWWWWWWWWWWWWWWWWWWWWWN...WWWWW
WWWW...NWWWWWWWWWWWWWWWWWWWWWWWWWWWWWWWWWWWWWWWWWWWND..WWWWW
WWWW.D.NWWWXXXXXXXXXXXXXXXXXXXXXXXXXXXXXXXXXXXXXWWWN..DWWWWW
WWWW...NWWWXMMMMMMMMMMMMMMMMMMMMMMMMMMMMMMMMMMMXWWWN.DDWWWWW
WWWW...NWWWXMDD...FFFFFF.........D..DD..DD..FFMXWWWN.D.WWWWW
WWWW.D.NWWWXMD....FFFFFF....................FFMXWWWN.D....WW
WWWW...NWWWXM.....FFBBFF..2.2.2.2.2...YXXXXX..MXWWWN......WW
WWWW...NWWWXM.....FFBBFF..............CMMMMX..MXWWWN......WW
WWWW...NWWWXM...XMFFFFFF........MX.......DMX..MXWWWNNNN...WW
WWWWD..NWWWXM...XMFFFFFF........MX........MX..MXWWWWWWN...WW
WWWW...NWWWXM...XMMMMMMM...MMMMMMX...YY...MX..MXWWWWWWN...WW
WWWWD..NWWWXM...XXXXXXXX...XXXXXXX...MM...MX..MXXXXWWWN...WW
WWWWD..NWWWXM.D.....................FFFFFF....MMMMXWWWN...WW
WWWWDD.NWWWXMD......................FFFFFF......DMXWWWN...WW
WWWW.D.NWWWXMMMMMM.....D............FFBBFF.......MXWWWN...WW
WWWW...NWWWXXXXXXM....D.......XXXXXXFFBBFFXXXX...MXWWWN...WW
WWWW...NWWWWWWWWXM......II....MMMMMMFFBBFFMMMM...MXWWWN...WW
WW.....NWWWWWWWWXMFF....II.D........FFFFFF.......MXWWWN...WW
WW.....NNNNNNWWWXMFF................FFFFFF...D...MXWWWN...WW
WW.....JJJJJNWWWXMTT............................DMXWWWN...WW
WW...NNNNNNNNWWWXMXX.......WWWWWW.........T...D.DMXWWWN...WW
WW...NWWWWWWWWWWXM...D.....WWWWWW..DTT.D..MMMMMMMMXWWWN...WW
WW...NWWWWWWWWWWXM......D..WWIIWW...XXD...MXXXXXXXXWWWN...WW
WW...NWWWXXXXXXXXM....XX...WWIIWW.........MXWWWWWWWWWWN...WW
WW...NWWWXMMMMMMMM....TT.D.WWWWWW.........MXWWWWWWWWWWN...WW
WW...NWWWXMDD....T.........WWWWWW.......XXMXWWWNNNNNNNN...WW
WW...NWWWXM.............................TTMXWWWNJJJJJ.....WW
WW...NWWWXMD......FFFFFF................FFMXWWWNNNNNN.....WW
WW...NWWWXM.......FFFFFF..........II....FFMXWWWWWWWWN.D...WW
WW...NWWWXM...MMMMFFBBFFMMMMMM....II......MXWWWWWWWWN.DDWWWW
WW...NWWWXM...XXXXFFBBFFXXXXXX...D...D....MXXXXXXWWWN..DWWWW
WW...NWWWXM.......FFBBFF............D.....MMMMMMXWWWN..DWWWW
WW...NWWWXM.......FFFFFF.......................MXWWWN.D.WWWW
WW...NWWWXMMMM....FFFFFF......................DMXWWWN...WWWW
WW...NWWWXXXXM..XM...MM...XXXXXXX...XXXXXXXX...MXWWWN...WWWW
WW...NWWWWWWXM..XM...CC...XMMMMMM...MMMMMMMX...MXWWWN...WWWW
WW...NWWWWWWXM..XM........XM..D.....FFFFFFMX...MXWWWN...WWWW
WW...NWWWWWWXM..XM........XM........FFFFFFMX...MXWWWN.D.WWWW
WW...NNNNWWWXM..XMMMMY..............FFBBFF.....MXWWWN...WWWW
WW......NWWWXM..XXXXXC...1.1.1.1.1..FFBBFF..D..MXWWWN...WWWW
WW......NWWWXMFF....................FFFFFF....DMXWWWN...WWWW
WW..DDD.NWWWXMFF..D.DD.....D........FFFFFF...D.MXWWWN...WWWW
WWWWW...NWWWXMMMMMMMMMMMMMMMMMMMMMMMMMMMMMMMMMMMXWWWN...WWWW
WWWWWD..NWWWXXXXXXXXXXXXXXXXXXXXXXXXXXXXXXXXXXXXXWWWN...WWWW
WWWWWD..NWWWWWWWWWWWWWWWWWWWWWWWWWWWWWWWWWWWWWWWWWWWN...WWWW
WWWWWD..NWWWWWWWWWWWWWWWWWWWWWWWWWWWWWWWWWWWWWWWWWWWN...WWWW
WWWWW...NWWWWWWWWWWWWWWWWWWWWWWWWWWWWWWWWWWWWWWWWWWWN...WWWW
WWWWW...NNNNNNNNNNNNNNNNNNNNNNNNNNNNNNNNNNNNNNNNNNNNN...WWWW
WWWWW...................................................WWWW
WWWWW...................................................WWWW
WWWWW...................................................WWWW
WWWWWWWWWWWWWWWWWWWWWWWWWWWWWWWWWWWWWWWWWWWWWWWWWWWWWWWWWWWW
WWWWWWWWWWWWWWWWWWWWWWWWWWWWWWWWWWWWWWWWWWWWWWWWWWWWWWWWWWWW