WWWWWWWWWWWWWWWWWWWWWWWWWWWWWWWWWWWWWWWWWWWWWWWWWWWWWWWWWWWW
WWWWWWWWWWWWWWWWWWWWWWWWWWWWWWWWWWWWWWWWWWWWWWWWWWWWWWWWWWWW
WWWWWWWWWWWWWWWWWWWWWWWWWWWWWWWWWWWWWWWWWWWWWWWWWWWWWWWWWWWW
WWWWWWWWWWWWWWWWWWWWWWWWWWWWWWWWWWWWWWWWWWWWWWWWWWWWWWWWWWWW
WWWWWWWWWWWWWWWWWWWWWWWWWWWWWWWWWWWWWWWWWWWWWWWWWWWWWWWWWWWW
WWWWWWWWWWWWWWWWWWWWWWWWWWWWWWWWWWWWWWWWWWWWWWWWWWWWWWWWWWWW
WWWWWWWWWWWWWWWWWWWWWWWWWWWWWWWWWWWWWWWWWWWWWWWWWWWWWWWWWWWW
WWWWWWWWWWWWWWWWWWWWWWWWWWWWWWWWWWWWWWWWWWWWWWWWWWWWWWWWWWWW
WWWWWWWWWWWWWWWWWWWWWWWWWWWWWWWWWWWWWWWWEEEEEEEEEWWWWWWWWWWW
WWWWWWWWWWWWWWWWWWWWWWWWWWWWWWWWEEEEEEEEE.......EWWWWWWWWWWW
WWWWWWWWWWWWWWWWWWWWEEEEEEEEEEEEE.............FFEWWWWWWWWWWW
WWWWWWWWWWWWWWEEEEEEE.....................FFFFFXEWWWWWWWWWWW
WWWWWWWWWWWWWWE......................FFFF.FFFFFXEWWWWXXXWWWW
WWWWWWWWWEEEEEE........M...MMM..f.MMMFFFF.FFMMMXEXWWWWWXWWWW
WWWWWWWWWE..........MMMM....MM....MMFFFFF....MMXEXWWWWWXXWWW
WWWWWWWWWE........MMMMMM....MMF..MMMFF.......MMMEXXXWWWWXWWW
WWWWWWWWWE.....FF.MMMM.......MF....FFF.......MMMEXXXWWWWXXWW
WWWWWWWWWE..FFFF..M..........MF.............FFMMEEXXXWWWXXWW
WWWWWWWWWE.FFFFF.............FF..MMM........FFMMMEXXXWWWWWWW
WWWWWWWWWE.FFMM.....2............MMM....T.....MMMEXXXWWWWWWW
WWWWWWWWWE...MM...2...2...........FMM........MMMMEXXXWWWWWWW
WWWWWWWWWE.FFFM...................FF.......f.MMMXEXXWWWWXWWW
WWWWWWWWWE.FFFM..2............T..............MMMXEXXWWWWXWWW
WWWWWWWWWE..FFMM.....FFFF.....WWW..........MMMMMXEWWWWWXXWWW
WWWWWWWWWE..FFF...2..FFF......WWWWWWW...FMMMMM...EWWWWWWWWWW
WWWWWWWWWEE..FF......FFFX....XWWWWWWWFFFFMMMMM...EWWWWWWWWWW
WWWWWWWWWWE..........F.XX....XXFFFFFFFFFFM.......EWWWWWWWWWW
WWWWWWWWWWE....................FFFFFFF...........EWWXWWWWWWW
WWWWWWWWWWE....FFCC............FFFFCC............EWWXWWWWWWW
WWWWWWWWWWE....FFF.........FF..FF.........FFF....EWWWWWWWWWW
WWWWWWWWWWE....FFF.........FF..FF.........FFF....EWWWWWWWWWW
WWWWWWWXWWE............CCFFFF............CCFF....EWWWWWWWWWW
WWWWWWWXWWE...........FFFFFFF....................EWWWWWWWWWW
WWWWWWWWWWE.......MFFFFFFFFFFXX....XX.F..........EWWWWWWWWWW
WWWWWWWWWWE...MMMMMFFFFWWWWWWWX....XFFF......FF..EEWWWWWWWWW
WWWWWWWWWWE...MMMMMF...WWWWWWW......FFF..1...FFF..EWWWWWWWWW
WWWXXWWWWWEXMMMMM..........WWW.....FFFF.....MMFF..EWWWWWWWWW
WWWXWWWWXXEXMMMd.............T............1..MFFF.EWWWWWWWWW
WWWXWWWWXXEXMMM.........FF...................MFFF.EWWWWWWWWW
WWWWWWWXXXEMMMM........MMF...........1...1...MM...EWWWWWWWWW
WWWWWWWXXXEMMM.....T....MMM............1.....MMFF.EWWWWWWWWW
WWWWWWWXXXEMMMFF........MMM..FF.............FFFFF.EWWWWWWWWW
WWXXWWWXXXEEMMFF.............FM..........M..FFFF..EWWWWWWWWW
WWXXWWWWXXXEMMM.......FFF....FM.......MMMM.FF.....EWWWWWWWWW
WWWXWWWWXXXEMMM.......FFMMM..FMM....MMMMMM........EWWWWWWWWW
WWWXXWWWWWXEXMM....FFFFFMMd...MM....MMMM..........EWWWWWWWWW
WWWWXWWWWWXEXMMMFF.FFFFMMM....MMM...M........EEEEEEWWWWWWWWW
WWWWXXXWWWWEXFFFFF.FFFF......................EWWWWWWWWWWWWWW
WWWWWWWWWWWEXFFFFF.....................EEEEEEEWWWWWWWWWWWWWW
WWWWWWWWWWWEFF.............EEEEEEEEEEEEEWWWWWWWWWWWWWWWWWWWW
WWWWWWWWWWWE.......EEEEEEEEEWWWWWWWWWWWWWWWWWWWWWWWWWWWWWWWW
WWWWWWWWWWWEEEEEEEEEWWWWWWWWWWWWWWWWWWWWWWWWWWWWWWWWWWWWWWWW
WWWWWWWWWWWWWWWWWWWWWWWWWWWWWWWWWWWWWWWWWWWWWWWWWWWWWWWWWWWW
WWWWWWWWWWWWWWWWWWWWWWWWWWWWWWWWWWWWWWWWWWWWWWWWWWWWWWWWWWWW
WWWWWWWWWWWWWWWWWWWWWWWWWWWWWWWWWWWWWWWWWWWWWWWWWWWWWWWWWWWW
WWWWWWWWWWWWWWWWWWWWWWWWWWWWWWWWWWWWWWWWWWWWWWWWWWWWWWWWWWWW
WWWWWWWWWWWWWWWWWWWWWWWWWWWWWWWWWWWWWWWWWWWWWWWWWWWWWWWWWWWW
WWWWWWWWWWWWWWWWWWWWWWWWWWWWWWWWWWWWWWWWWWWWWWWWWWWWWWWWWWWW
WWWWWWWWWWWWWWWWWWWWWWWWWWWWWWWWWWWWWWWWWWWWWWWWWWWWWWWWWWWW
WWWWWWWWWWWWWWWWWWWWWWWWWWWWWWWWWWWWWWWWWWWWWWWWWWWWWWWWWWWW