WWWWWWWWWWWWWWWWWWWWWWWWWWWWWWWWWWWWWWWWWWWWWWWWWWWWWWWWWWWW
WWWWWWWWWWWWWWWWWWWWWWWWWWWWWWWWWWWWWWWWWWWWWWWWWWWWWWWWWWWW
WW.......................................................WWW
WW.......................................................WWW
WW.......................................................WWW
WW.......................................................WWW
WW.......................................................WWW
WW.......................................................WWW
WW.......................................................WWW
WWWWWWWWWWWWWWWWWWWWWWWWWWWWWWWWWWWWWWWWWWWWWWWWWWWWWWWWWWWW
WWWWWWWWWWWWWWWWWWWWWWWWWWWWWWWWWWWWWWWWWWWWWWWWWWWWWWWWWWWW
WWWWWWWWWWWWWWWWWWWWWWWWWWWWWWWWWWWWWWWWWWWWWWWWWWWWWWWWWWWW
WWWWWWWWWWWWWWWWWWWWWWWWWWWWWWWWWWWWWWWWWWWWWWWWWWWWWWWWWWWW
WWWWWWWWWWWWWWWWWWWWWWWWWWWWWWWWWWWWWWWWWWWWWWWWWWWWWWWWWWWW
WWWWWWWWWWWWWWWWWWWWWWWWWWWWWWWWWWWWWWWWWWWWWWWWWWWWWWWWWWWW
WWWWWWMMWWWWWWWWWWWWWWWWWWWWWWWWWWWWWWWWWWWWWWWWWWWMMWWWWWWW
WWWWWWMMWWWWWWWWWWWWWWXXXXXXXXXXXXXXXWWWWWWWWWWWWWWMMWWWWWWW
WWWWWWWWWWWWWWWWWWWWWWXFFFFFFFFFFFFFXWWWWWWWWWWWWWWWWWWWWWWW
WWWWWWWWWWXXXXXXXXXXXXX.............XXXXXXXXXXXXXWWWWWWWWWWW
WWMMWWWWWWXD....BB..B....2.2.2.2.2..BBD.......DDXWWWWWWMMWWW
WWMMWWWXXXX.......D..................B.....D...DXXXXWWWMMWWW
WWWWWWWXFFF.....................................FFFXWWWWWWWW
WWWWWWWXF.........................................FXWWWWWWWW
WWWWWWWXF....XXYYCXXFFFXX...........CCYXXFFFXXBB..FXWWWWWWWW
WWWWWXXXF....XXCCCXXFFFXX....II....CCYYXXFFFXXB...FXXXWWWWWW
WMMWWXFFF....................II......FFCC.........FFFXWWMMWW
WMMWWXF.....................BMM......FFCC.....D.....FXWWMMWW
WWWWWXF..............D...BBBBWWC.......C............FXWWWWWW
WWWWWXF...BTWWWWT.......TWWWWWWYCC..................FXWWWWWW
WWWWWXF....TWWWWT.......TWWWWWWWWWT.......TWWWWT....FXWWWWWW
WWWWWXF..................CYYWWWWWWT.......TWWWWTB...FXWWWWWW
WWWWWXF............Y.......CWWBBBB....D.............FXWWWWWW
WMMWWXF....D......YYFF......MMB......D..............FXWWMMWW
WMMWWXFFF.........CCFF......II....................FFFXWWMMWW
WWWWWXXXF...BXXFFFXXCCY.....II....XXFFFXXCCYXX....FXXXWWWWWW
WWWWWWWXF..BBXXFFFXXCCYY..........XXFFFXXCYCXX....FXWWWWWWWW
WWWWWWWXF.........................................FXWWWWWWWW
WWWWWWWXFFF.......D.............................FFFXWWWWWWWW
WWMMWWWXXXXD...DD....B.........................DXXXXWWWMMWWW
WWMMWWWWWWX.D........BB..1.1.1.1.1...B..BB....D.XWWWWWWMMWWW
WWWWWWWWWWXXXXXXXXXXXXX.............XXXXXXXXXXXXXWWWWWWWWWWW
WWWWWWWWWWWWWWWWWWWWWWXFFFFFFFFFFFFFXWWWWWWWWWWWWWWWWWWWWWWW
WWWWWWMMWWWWWWWWWWWWWWXXXXXXXXXXXXXXXWWWWWWWWWWWWWWMMWWWWWWW
WWWWWWMMWWWWWWWWWWWWWWWWWWWWWWWWWWWWWWWWWWWWWWWWWWWMMWWWWWWW
WWWWWWWWWWWWWWWWWWWWWWWWWWWWWWWWWWWWWWWWWWWWWWWWWWWWWWWWWWWW
WWWWWWWWWWWWWWWWWWWWWWWWWWWWWWWWWWWWWWWWWWWWWWWWWWWWWWWWWWWW
WWWWWWWWWWWWWWWWWWWWWWWWWWWWWWWWWWWWWWWWWWWWWWWWWWWWWWWWWWWW
WWWWWWWWWWWWWWWWWWWWWWWWWWWWWWWWWWWWWWWWWWWWWWWWWWWWWWWWWWWW
WWWWWWWWWWWWWWWWWWWWWWWWWWWWWWWWWWWWWWWWWWWWWWWWWWWWWWWWWWWW
WWWWWWWWWWWWWWWWWWWWWWWWWWWWWWWWWWWWWWWWWWWWWWWWWWWWWWWWWWWW
WW.......................................................WWW
WW.......................................................WWW
WW.......................................................WWW
WW.......................................................WWW
WW.......................................................WWW
WW.......................................................WWW
WW.......................................................WWW
WW.......................................................WWW
WWWWWWWWWWWWWWWWWWWWWWWWWWWWWWWWWWWWWWWWWWWWWWWWWWWWWWWWWWWW
WWWWWWWWWWWWWWWWWWWWWWWWWWWWWWWWWWWWWWWWWWWWWWWWWWWWWWWWWWWW