WWWWWWWWWWWWWWWWWWWWWWWWWWWWWWWWWWWWWWWWWWWWWWWWWWWWWWWWWWWW
WWWWWWWWWWWWWWWWWWWWWWWWWWWWWWWWWWWWWWWWWWWWWWWWWWWWWWWWWWWW
WWWWWWWWWWWWWWWWWWWWWWWWWWWWWWWWWWWWWWWWWWWWWWWWWWWWWWWWWWWW
WWWWWWWWWWWWWWWWWWWWWWWWWWWWWWWWWWWWWWWWWWWWWWWWWWWWWWWWWWWW
WWWWWWWWWWWWWWWWWWWWWWWWWWWWW WWWWWWWWWWWWWWWWWWWWWWWWWWWWWW
WWWWWWWWWWWWWWWWWWWWWWWWWWWWWWWWWWWWWWWWWWWWWWWWWWWWWWWWWWWW
WWWWWWWWWWWWWWWWWWWWTTTTTTTWWWWWWWWWWWWWWWWWWWWWWWWWWWWWWWWW
WWWWWWWWWT».…»TWWWWWT»...»TWWWWWWW».WWWTWWWWWWWWWWWWWWWWWWWW
WWWWWWWWWT....TWWWWWT.....TWWWWWWW..WWWTTTTWWWWYYYYWWWWWWWWW
WWWWWWWWWTTTTTTTTTTTTTTTTTTTTTTTTTTTWWWT».…WWWWWWWWWWWWWWWWW
WWWW WWWWTEEEEEEEEEEEEEEEEEEEEEEEEEEWWWT...WWWWWWWWWWWWWWWWW
WWWWWWWWWTE........................EWWWTTTTTWWWWWWWWWWWWWWWW
WWWWWWWWWTE...........2.2.2.2.2.FF.EWWWWWWWWWWWWWYYYYYYWWWWW
WWWWWWWWWWE.....................FF.EWWWWWWWWWWWWWWWCCWWWWWWW
WWWWWWWWWWE.....................FF.EEEEEEEEEEWWWWWWWWWWWWWWW
WWWWWWWWWWE.....................FF..........EWWWWWWWWWWWWWWW
WWWWWYYYWWEFFFF..FFFF...........FF..........EWWWWWWWWWWWWWWW
WWWWWYYYWWEMMMF..FMMMXX...XXMMM.FF........FFEWWWWWWWWWWWWWWW
WWWWWCCCWWE.................MMM.FF........FFEEEEEEEEWWW WWWW
WWWWWWWWWWE.L...............MMM.FF.XMM....FFFFFFFFFEWWWWWWWW
WWWWWWWWWWE.................YYY.FF.YYY....FFFFFFFFFEWWWWWWWW
WWWWWWWWWTE.....................FF........FFF....FFEWWWWWWWW
WWWWWWWWWTE.....................FF...............FFEWWWWWWWW
WWWWWWWWWTEEEEEEENNNN.......MMM.FF.MMM....TT.....FFEWWWWWWWW
WWWWWWWWWTTTTTTTEN...........MM.FF.MM............FFEWWYYWWWW
WWWWWWW.........EN...........MM....MM............FFEWWYYWWWW
WWWWWWW.........E......FFFFF.XX.FF.MM............FFEWWWWWWWW
WWW WWWTTTTTTTTTE......TTTFF....FF.MMXX......III.FFEWWWWWWWW
WWWWWWWTEEEEEEEEEF........FF..............FF.....FFETWWWWWWW
WWWWWWWTEFFFFFFFFF........................FFFFFFFFFETWWWWWWW
WWWWWWWTEFFFFFFFFF........................FFFFFFFFFETWWWWWWW
WWWWWWWTEFF.....FF..............FF........FEEEEEEEEETWWWWWWW
WWWWWWWWEFF.III......XXMM.FF....FFTTT......ETTTTTTTTTWWW WWW
WWWWWWWWEFF............MM.FF.XX.FFFFF......E.........WWWWWWW
WWWWYYWWEFF............MM....MM...........NE.........WWWWWWW
WWWWYYWWEFF............MM.FF.MM...........NETTTTTTTWWWWWWWWW
WWWWWWWWEFF.....TT....MMM.FF.MMM.......NNNNEEEEEEETWWWWWWWWW
WWWWWWWWEFF...............FF.....................ETWWWWWWWWW
WWWWWWWWEFF....FFF........FF.....................ETWWWWWWWWW
WWWWWWWWEFFFFFFFFF....YYY.FF.YYY..............K..EWWWWWWWWWW
WWWWWWWWEFFFFFFFFF....MMX.FF.MMM.................EWWWWWWWWWW
WWWW WWWEEEEEEEEFF........FF.MMM.................EWWCCCWWWWW
WWWWWWWWWWWWWWWEFF........FF.MMMXX...XXMMMF..FMMMEWWYYYWWWWW
WWWWWWWWWWWWWWWE..........FF...........FFFF..FFFFEWWYYYWWWWW
WWWWWWWWWWWWWWWE..........FF.....................EWWWWWWWWWW
WWWWWWWWWWWWWWWEEEEEEEEEE.FF.....................EWWWWWWWWWW
WWWWWWWCCWWWWWWWWWWWWWWWE.FF.....................EWWWWWWWWWW
WWWWWYYYYYYWWWWWWWWWWWWWE.FF.1.1.1.1.1...........ETWWWWWWWWW
WWWWWWWWWWWWWWWWTTTTTWWWE........................ETWWWWWWWWW
WWWWWWWWWWWWWWWWW...TWWWEEEEEEEEEEEEEEEEEEEEEEEEEETWWWW WWWW
WWWWWWWWWWWWWWWWW….»TWWWTTTTTTTTTTTTTTTTTTTTTTTTTTTWWWWWWWWW
WWWWWWWWWYYYYWWWWTTTTWWW..WWWWWWWT.....TWWWWWT....TWWWWWWWWW
WWWWWWWWWWWWWWWWWWWWTWWW.»WWWWWWWT»...»TWWWWWT»….»TWWWWWWWWW
WWWWWWWWWWWWWWWWWWWWWWWWWWWWWWWWWTTTTTTTWWWWWWWWWWWWWWWWWWWW
WWWWWWWWWWWWWWWWWWWWWWWWWWWWWWWWWWWWWWWWWWWWWWWWWWWWWWWWWWWW
WWWWWWWWWWWWWWWWWWWWWWWWWWWWWW WWWWWWWWWWWWWWWWWWWWWWWWWWWWW
WWWWWWWWWWWWWWWWWWWWWWWWWWWWWWWWWWWWWWWWWWWWWWWWWWWWWWWWWWWW
WWWWWWWWWWWWWWWWWWWWWWWWWWWWWWWWWWWWWWWWWWWWWWWWWWWWWWWWWWWW
WWWWWWWWWWWWWWWWWWWWWWWWWWWWWWWWWWWWWWWWWWWWWWWWWWWWWWWWWWWW
WWWWWWWWWWWWWWWWWWWWWWWWWWWWWWWWWWWWWWWWWWWWWWWWWWWWWWWWWWWW