WWWWWWWWWWWWWWWWWWWWWWWWWWWWWWWWWWWWWWWWWWWWWWWWWWWWWWWWWWWW
WWWWWWWWWWWWWWWWWWWWWWWWWWWWWWWWWWWWWWWWWWWWWWWWWWWWWWWWWWWW
WWWWWWWWWWWWWWWWWWWWWWWWWWWWWWWWWWWWWWWWWWWWWWWWWWWWWWWWWWWW
WWWWWWWWWWWWWWWWWWWWWWWWWWWWWWWWWWWWWWWWWWWWWWWWWWWWWWWWWWWW
WWWWWWWWWWWWWWWWWWWWWWWWWWWWWWWWWWWWWWWWWWWWWWWWWWWWWWWWWWWW
WWWWWWWWWWWWWWWWWWWWWWWWWWWWWWWWWWWWWWWWWWWWWWWWWWWWWWWWWWWW
WWWWWWWWWWWWWWWWWWWWWWWWWWWWWWWWWWWWWWWWWWWWWWWWWWWWWWWWWWWW
WWWWWWWWWWWWWWWWWWWWWWWWWWWWWWWWWWWWWWWWWWWWWWWWWWWWWWWWWWWW
WWWWWWWWWWWWWWWWWWWWWWWWWWWWWWWWWWWWWWWWWWWWWWWWWWWWWWWWWWWW
WWWWWWWWWWWWWWWWWWWWWWWWWWWWWWWWWWWWWWWWWWWWWWWWWWWWWWWWWWWW
WWWWWWWWWWWWWWWWWWWWWWWWWWWWWWWWWWWWWWWWWWWWWWWWWWWWWWWWWWWW
WWWWWWWWWWWWW............D............D...........WWWWWWWWWW
WWWWWWWWWWWWW....D.D...................D..........WWWWWWWWWW
WWWWWWWWWWWWW..EEEEEEEEEEEEEEEEEEEEEEE.D.EEEEEEE..WWWWWWWWWW
WWWWWWWWWWWWWD.E........D............E...EFFFFFE..WWWWWWWWWW
WWWWWWWWWWWWW..ED.....D...2.2.2.2.2..EEEEEFFFFFE..WWWWWWWWWW
WWWWWWWWWWWWW..E..NX...D.......................E.DWWWWWWWWWW
WWWWWWWWWWWWW..E..NX...........................E.DWWWWWWWWWW
WWWWWWWWWWWWW..E..NXXXX...IIFFFII..D..MMMM..DD.E..WWWWWWWWWW
WWWWWWWWWWWWW.DE..NNNNN...IIFFFII.....NNNN..D..E..WWWWWWWWWW
WWWWWWWWWWWWW.DE..............................DED.WWWWWWWWWW
WWWWWWWWWWWWW..E...............................E..WWWWWWWWWW
WWWWWWWWWWWWWD.EEE..FF..CC........CC..NNNNNNN..E..WWWWWWWWWW
WWWWWWWWWWWWW....E..FF..CC...L....CC..NXXXXXX..E..WWWWWWWWWW
WWWWWWWWWWW....D.E..FF................NX.......E..WWWWWWWWWW
WWWWWWWWWWW......E..FF................NX.......E..WWWWWWWWWW
WWWWWWWWWWW..EEEEE..FF..D.IIIIII.FFF..NX.......E.DWWWWWWWWWW
WWWWWWWWWWW..EFFFF........I.......FF..NX...NNNNE..WWWWWWWWWW
WWWWWWWWWWW..EFFFF........I.DD.............NYYYE..WWWWWWWWWW
WWWWWWWWWWW..EFFFF..C..H..I.D.....I........NYYYE..WWWWWWWWWW
WWWWWWWWWWW..EFFFF..C.....I...T...I.G...C..FFFFE..WWWWWWWWWW
WWWWWWWWWWW..ENNNN........I.......I.....C..FFFFE..WWWWWWWWWW
WWWWWWWWWWW..ENMMM..............D.I........FFFFE..WWWWWWWWWW
WWWWWWWWWWW..ENMMM...MN..FF.......I........FFFFE..WWWWWWWWWW
WWWWWWWWWWW..E.......MN..FFF.IIIIII....FF..EEEEE..WWWWWWWWWW
WWWWWWWWWWW..E.......MN................FF..E....D.WWWWWWWWWW
WWWWWWWWWWW..E.......MN.......K........FF..E..D...WWWWWWWWWW
WWWWWWWWWWW..E..MMMMMMN..CC........CC..FF..E....WWWWWWWWWWWW
WWWWWWWWWWW..E..NNNNNNN..CC........CC..FF..EEE..WWWWWWWWWWWW
WWWWWWWWWWW..E...............................E..WWWWWWWWWWWW
WWWWWWWWWWW..ED..............................E..WWWWWWWWWWWW
WWWWWWWWWWW..E..D..NNNN..D..IIFFFII...NNNNN.DE..WWWWWWWWWWWW
WWWWWWWWWWW..E.DD..XXXX.....IIFFFII...MMMMN..E..WWWWWWWWWWWW
WWWWWWWWWWW..E............D..............MN..E..WWWWWWWWWWWW
WWWWWWWWWWW..E.......................D...MN..E..WWWWWWWWWWWW
WWWWWWWWWWW..EFFFFFEEEEE..1.1.1.1.1..DD......E..WWWWWWWWWWWW
WWWWWWWWWWW..EFFFFFE...E...........D....D....E..WWWWWWWWWWWW
WWWWWWWWWWW..EEEEEEE.D.EEEEEEEEEEEEEEEEEEEEEEE..WWWWWWWWWWWW
WWWWWWWWWWW....D...................D.D..........WWWWWWWWWWWW
WWWWWWWWWWW..........DD..................D......WWWWWWWWWWWW
WWWWWWWWWWWWWWWWWWWWWWWWWWWWWWWWWWWWWWWWWWWWWWWWWWWWWWWWWWWW
WWWWWWWWWWWWWWWWWWWWWWWWWWWWWWWWWWWWWWWWWWWWWWWWWWWWWWWWWWWW
WWWWWWWWWWWWWWWWWWWWWWWWWWWWWWWWWWWWWWWWWWWWWWWWWWWWWWWWWWWW
WWWWWWWWWWWWWWWWWWWWWWWWWWWWWWWWWWWWWWWWWWWWWWWWWWWWWWWWWWWW
WWWWWWWWWWWWWWWWWWWWWWWWWWWWWWWWWWWWWWWWWWWWWWWWWWWWWWWWWWWW
WWWWWWWWWWWWWWWWWWWWWWWWWWWWWWWWWWWWWWWWWWWWWWWWWWWWWWWWWWWW
WWWWWWWWWWWWWWWWWWWWWWWWWWWWWWWWWWWWWWWWWWWWWWWWWWWWWWWWWWWW
WWWWWWWWWWWWWWWWWWWWWWWWWWWWWWWWWWWWWWWWWWWWWWWWWWWWWWWWWWWW
WWWWWWWWWWWWWWWWWWWWWWWWWWWWWWWWWWWWWWWWWWWWWWWWWWWWWWWWWWWW
WWWWWWWWWWWWWWWWWWWWWWWWWWWWWWWWWWWWWWWWWWWWWWWWWWWWWWWWWWWW