WWWWWWWWWWWWWWWWWWWWWWWWWWWWWWWWWWWWWWWWWWWWWWWWWWWWWWWWWWWW
WWWWWWWWWWWWWWWWWWWMMMMWWWWWWWWWWWWWWMMMMWWWWWWWWWWWWWWWWWWW
WWWWWWWWWWWWWWWWWWWMMMMWWWWWWWWWWWWWWMMMMWWWWWWWWWWWWWWWWWWW
WWWWWWWWWWWWWWWWWWWMMMMWWWWWWWWWWWWWWMMMMWWWWWWWWWWWWWWWWWWW
WWWWWWWWWWWWWWWWWWWMMMMWWWWWWWWWWWWWWMMMMWWWWWWWWWWWWWWWWWWW
WWWWWWWWWWWWWWWWWWWWWWWWWWWWWWWWWWWWWWWWWWWWWWWWWWWWWWWWWWWW
WWWWWWWWWWWWWWWWWWWWWWWWWWWWWWWWWWWWWWWWWWWWWWWWWWWWWWWWWWWW
WWWWWWWWWWWWWWWWWWWMMMMWWMMMMWWWWWWWWWWWWWWWWWWWWWWWWWWWWWWW
WWWWWWWWWWWWWWWWWWWMMMMWWMMMMWWWWWWWWWWWWWWWWWWWWWÊWWWWWWWWW
WWWWWWWWWWWWWWWWWWWMMMMWWMMMMWWWWWWWWWWWWWWWWWWWWWWWWWWWWWWW
WWWWWWWWWWWWÊWWWWWWMMMMWWMMMMWWWWÊWWWWWWWWWWWWWWWWWWWWWWWWWW
WWWWWWWWWWWWWWWWWWWWWWWWWWWWWWWWWWWWWWWWWWWWWWWWWWWWWWWWWWWW
WWWWWWWWWWWWWWWWWWWWWWWWWWWWWWWWWWWWWWWWWWWWWWWWWWWWWWWWWWWW
WWWWWWWWWWWWWWWWWWWMMMMWWWWWWWWWWWWWWMMMMWWWWWWWWWWWWWWWWWWW
WWWWWWWWEEEEEEEEEEEEEEEEEEEEEEEEEEEEEEEEEEEEEEEEEEEEWWWWWWWW
WWWWWWWWE.................222..22........D.........EWWWWWWWW
WWWWWWWWE.D......FF................................EWWWWWWWW
WWWWWWWWE........FF....FF................FF........EWWWWWWWW
WWWWWWWWE........FF....FF.D.ww.....FF....FF........EWWWWWWWW
WMMMMWWME....MMMM..MMMMFFMMIIw.IMMMFFMMMM..MMMM.D..EWWWWWWWW
WMMMMWWME....MMM...MMMMFFMMMIw.IMMMFFMMMM...MMM....EWWWWWWWW
WMMMMWWME....YMMD..MMMM..MMMI.wIMMMFFMMMM...MMY....EWWWWWWWW
WMMMMWWME....CYM...MMMM..MMMI.wIIMMD.MMMM...MYC....EWWWWWWWW
WWWWWWWWE..FFFF...FFFF........wwww.....FFFF..FFFFF.EWWWWWWWW
WWWWWWWWE..FFFF...FFFFD................FFFF..FFFFFDEWWWWWWWW
WWWWWWWWEEEEFFMYw..MMMM..............MMMM...YMFFEEEEWWWWWWWW
WWWWWWWWWWWEFFMMw..MMMMw.............MMMMw..MMFFEWWWWWWWWWWW
WWWWWWWWWWWEFF.Mw..MMMIw...T....T....MMMIwD.M.FFEWWWWWWWWWWW
WWWWWWWWWWWEFF.ww..IIIIw..D...D......IIIIw....FFEWWWWWWWWWWW
WWWWWWWWWWWEFF......Dwww.....FF........www....FFEWWWWWÊWWWWW
WWWWWÊWWWWWEFF....www........FF.....wwwD......FFEWWWWWWWWWWW
WWWWWWWWWWWEFF....wIIII......D...D..wIIII..ww.FFEWWWWWWWWWWW
WWWWWWWWWWWEFF.M.DwIMMM....T....T...wIMMM..wM.FFEWWWWWWWWWWW
WWWWWWWWWWWEFFMM..wMMMM.............wMMMM..wMMFFEWWWWWWWWWWW
WWWWWWWWEEEEFFMY...MMMM..............MMMM..wYMFFEEEEWWWWWWWW
WWWWWWWWEDFFFFF..FFFF................DFFFF...FFFF..EWWWWWWWW
WWWWWWWWE.FFFFF..FFFF.....wwww........FFFF...FFFF..EWWWWWWWW
WWWWWWWWE....CYM...MMMM.DMMIIw.IMMM..MMMM...MYC....EMWWMMMMW
WWWWWWWWE....YMM...MMMMFFMMMIw.IMMM..MMMM..DMMY....EMWWMMMMW
WWWWWWWWE....MMM...MMMMFFMMMI.wIMMMFFMMMM...MMM....EMWWMMMMW
WWWWWWWWE..D.MMMM..MMMMFFMMMI.wIIMMFFMMMM..MMMM....EMWWMMMMW
WWWWWWWWE........FF....FF.....ww.D.FF....FF........EWWWWWWWW
WWWWWWWWE........FF................FF....FF........EWWWWWWWW
WWWWWWWWE................................FF......D.EWWWWWWWW
WWWWWWWWE.........D........11..111.................EWWWWWWWW
WWWWWWWWEEEEEEEEEEEEEEEEEEEEEEEEEEEEEEEEEEEEEEEEEEEEWWWWWWWW
WWWWWWWWWWWWWWWWWWWMMMMWWWWWWWWWWWWWWMMMMWWWWWWWWWWWWWWWWWWW
WWWWWWWWWWWWWWWWWWWWWWWWWWWWWWWWWWWWWWWWWWWWWWWWWWWWWWWWWWWW
WWWWWWWWWWWWWWWWWWWWWWWWWWWWWWWWWWWWWWWWWWWWWWWWWWWWWWWWWWWW
WWWWWWWWWWWWWWWWWWWWWWWWWWÊWWWWMMMMWWMMMMWWWWWWÊWWWWWWWWWWWW
WWWWWWWWWWWWWWWWWWWWWWWWWWWWWWWMMMMWWMMMMWWWWWWWWWWWWWWWWWWW
WWWWWWWWWÊWWWWWWWWWWWWWWWWWWWWWMMMMWWMMMMWWWWWWWWWWWWWWWWWWW
WWWWWWWWWWWWWWWWWWWWWWWWWWWWWWWMMMMWWMMMMWWWWWWWWWWWWWWWWWWW
WWWWWWWWWWWWWWWWWWWWWWWWWWWWWWWWWWWWWWWWWWWWWWWWWWWWWWWWWWWW
WWWWWWWWWWWWWWWWWWWWWWWWWWWWWWWWWWWWWWWWWWWWWWWWWWWWWWWWWWWW
WWWWWWWWWWWWWWWWWWWMMMMWWWWWWWWWWWWWWMMMMWWWWWWWWWWWWWWWWWWW
WWWWWWWWWWWWWWWWWWWMMMMWWWWWWWWWWWWWWMMMMWWWWWWWWWWWWWWWWWWW
WWWWWWWWWWWWWWWWWWWMMMMWWWWWWWWWWWWWWMMMMWWWWWWWWWWWWWWWWWWW
WWWWWWWWWWWWWWWWWWWMMMMWWWWWWWWWWWWWWMMMMWWWWWWWWWWWWWWWWWWW
WWWWWWWWWWWWWWWWWWWWWWWWWWWWWWWWWWWWWWWWWWWWWWWWWWWWWWWWWWWW