WWWWWWWWWWWWWWWWWWWWWWWWWWWWWWWWWWWWWWWWWWWWWWWWWWWWWWWWWWWW
WWWWWWWWWWWWWWWWWWWWWWWWWWWWWWWWWWWWWWWWWWWWWWWWWWWWWWWWWWWW
WWWWWWWWWWWWWWWWWWWWWWWWWWWWWWWWWWWWWWWWWWWWWWWWWWWWWWWWWWWW
WWWWWWWWWWWWWWWWWWWWWWWWWWWWWWWWWWWWWWWWWWWWWWWWWWWWWWWWWWWW
WWWWWWWWWWWWWWWWWWWWWWWWWWWWWWWWWWWWWWWWWWWWWWWWWWWWWWWWWWWW
WWWWWWWWWWWWWWWWWWWWWWWWWWWWWWWWWWWWWWWWWWWWWWWWWWWWWWWWWWWW
WWWWWWWWWWWWWWWWWWWWWWWWWWWWWWWWWWWWWWWWWWWWWWWWWWWWWWWWWWWW
WWWWWWWWEEEEEWWWWWWWWWWWWWWWWWWWWWWWWWWWWWWWWWWWWWWWWWWWWWWW
WWWWWWWWETTTEWWWWWWWWWWWWWWWWWWWWWWWWWWWWWWWWWEEEEEWWWWWWWWW
WWWWWWWWE...EEEEEEEEWWWWWWWWWWWWWWWWWWWWWWWWWWETTTEWWWWWWWWW
WWWWWEEEE.........MEWWWWWWWWWWWWWWWWWWWWWEEEEEE...EEEEEEWWWW
WWWWWEC...........MEWWWWWWWWWWWWWWWWWWWWWEFFFFF.......CEWWWW
WWWWWE...........P.EWWWWWWWWWWWWWEEEEEEEEEFF...........EEEWW
WWEEEE.............EWWWWWWWWWEEEEE.....FFFFF.............EWW
WWE.FF......MM....MEWWWWWEEEEEC......................FFF.EWW
WWE.FF......M.....MEEEEEEE....................MM.....MFF.EWW
WWE.FF......M.....MMFFFFFF..................MMMM.....MFF.EWW
WWE.FFMMMFFFF.....MMFF.................YYY.....FFFFMMMFF.EWW
CCE.FFFFFFFFF.....MMFF............YYY..........FFFFFFFFF.ECC
MME........FF.....FFFF...MMMMYYY...............FF........EMM
MME......................MMMMFFFF........................EMM
WWEMMM.................YYMMFFFFFF.....................MMMEWW
WWEMMM............YYY......FFFF.....................f.EEEEWW
WWEEEEe......YYY..FF.........FF.........FF.......MMM..EWWWWW
WWWWWE..MMM.......FF.........FF.........FF..YYY..MMEEEEWWWWW
WWWWWEEEEMMF.1.........................YYY......FMMEWWWWWWWW
WWWWWWWWEMMF..........d.MMMM.....CYYY.........2.FMMEWWWWWWWW
WWWWWWWWEMMF.1..........MMMM.....CY.............FMMEWWWWWWWW
WWWWWWWWEMMF...MMMMWWWWWMM...............c....2.FMMEWWWWWWWW
WWWWWWWWEMMF.1.MMMMWWWWWFF........FF.......MM...FMMEWWWWWWWW
WWWWWWWWEMMF...MMd......FF........FFWWWWWMMMM.2.FMMEWWWWWWWW
WWWWWWWWEMMF.1....................MMWWWWWMMMM...FMMEWWWWWWWW
WWWWWWWWEMMF.............YC.....MMMMc.........2.FMMEWWWWWWWW
WWWWWWWWEMMF.1.........YYYC.....MMMM............FMMEWWWWWWWW
WWWWWWWWEMMF......YYY.........................2.FMMEEEEWWWWW
WWWWWEEEEMM..YYY..FF.........FF.........FF.......MMMf.EWWWWW
WWWWWEe.MMM.......FF.........FF.........FF..YYY.......EEEEWW
WWEEEE.......................FFFF......YYY............MMMEWW
WWEMMM.....................FFFFFFMMYY.................MMMEWW
MME........................FFFFMMMM......................EMM
MME........FF...............YYYMMMM...FFFF.....FF........EMM
CCE.FFFFFFFFF..........YYY............FFMM.....FFFFFFFFF.ECC
WWE.FFMMMFFFF.....YYY.................FFMM.....FFFFMMMFF.EWW
WWE.FFM.....MMMM..................FFFFFFMM.....M......FF.EWW
WWE.FFM.....MM....................EEEEEEEM.....M......FF.EWW
WWE.FFF......................CEEEEEWWWWWEM....MM......FF.EWW
WWE.............FFFFF.....EEEEEWWWWWWWWWEZ............EEEEWW
WWEEE...........FFEEEEEEEEEWWWWWWWWWWWWWE.............EWWWWW
WWWWEC.......FFFFFEWWWWWWWWWWWWWWWWWWWWWEM...........CEWWWWW
WWWWEEEEEE...EEEEEEWWWWWWWWWWWWWWWWWWWWWEM.........EEEEWWWWW
WWWWWWWWWETTTEWWWWWWWWWWWWWWWWWWWWWWWWWWEEEEEEEE...EWWWWWWWW
WWWWWWWWWEEEEEWWWWWWWWWWWWWWWWWWWWWWWWWWWWWWWWWETTTEWWWWWWWW
WWWWWWWWWWWWWWWWWWWWWWWWWWWWWWWWWWWWWWWWWWWWWWWEEEEEWWWWWWWW
WWWWWWWWWWWWWWWWWWWWWWWWWWWWWWWWWWWWWWWWWWWWWWWWWWWWWWWWWWWW
WWWWWWWWWWWWWWWWWWWWWWWWWWWWWWWWWWWWWWWWWWWWWWWWWWWWWWWWWWWW
WWWWWWWWWWWWWWWWWWWWWWWWWWWWWWWWWWWWWWWWWWWWWWWWWWWWWWWWWWWW
WWWWWWWWWWWWWWWWWWWWWWWWWWWWWWWWWWWWWWWWWWWWWWWWWWWWWWWWWWWW
WWWWWWWWWWWWWWWWWWWWWWWWWWWWWWWWWWWWWWWWWWWWWWWWWWWWWWWWWWWW
WWWWWWWWWWWWWWWWWWWWWWWWWWWWWWWWWWWWWWWWWWWWWWWWWWWWWWWWWWWW
WWWWWWWWWWWWWWWWWWWWWWWWWWWWWWWWWWWWWWWWWWWWWWWWWWWWWWWWWWWW