WWWWWWWWWWWWWWWWWWWWWWWWWWWWWWWWWWWWWWWWWWWWWWWWWWWWWWWWWWWW
WWWWWWWWWWWWWWWWWWWWWWWWWWWWWWWWWWWWWWWWWWWWWWWWWWWWWWWWWWWW
WWWWWWWWWWWWWWWWWWWWWWWWWWWWWWWWWWWWWWWWWWWWWWWWWWWWWWWWWWWW
WWWWWWWWWWWWWWWWWWWWWWWWWWWWWWWWWWWWWWWWWWWWWWWWWWWWWWWWWWWW
WWWWWWWWWWWWWWWWWWWWWWWWWWWWWWWWWWWWWWWWWWWWWWWWWWWWWWWWWWWW
WWWWWWWWWWWWWWWWWWWWWWWWWWWWWWWWWWWWWWWWWWWWWWWWWWWWWWWWWWWW
WWWWWWWWWWWWWWWWWWWWWWWWWWWWWWWWWWWWWWWWWWWWWWWWWWWWWWWWWWWW
WWWWWWWWWWWWWWWWWWWWWWWWWWWWWWWWWWWWÊWWWWWWWWWWWWWWWWWWWWWWW
WWWWWWWWWWWWWWWWWWWWWWWWWWWWWWWWWWWWWWWWWWWWWWWWWWWWWWWWWWWW
WWWWWWWWWWWÊWWWWWWWWWWWÊWWWWWWWWWWWWWWWWWWWWWWWWWWWWWWWWWWWW
WWWWWWWWWWWWWWWWWWWWWWWWWWWWWWWWWWWWWWWWWWWWWWWWWWÊWWWWWWWWW
WWWWWWWWWWWWWWWWWWWWWWWWWWWWWWWWWWWWWWWWWWWWWWWWWWWWWWWWWWWW
WWWWWWWWWWWWWFD.MD.DEEEEEEEEEEEEEEEEEEEED.DM.DFWWWWWWWWWWWWW
WWWWWWWWWWWFDÈ.É.FÉDE.FFF.......FFFFFFFEDÉ.FÉ.ÈDFWWWWWWWWWWW
WWWWWWWWWWFD.FF.FFFFE..FF........FFFFF.EFFFF.FF..FWWWWWWWWWW
WWWWWWWWWW.ÈFEEEEEEEE...F.........FFF..EEEEEEEEFÈDWWWWWWWWWW
WWWWWWWWWX.FFEFFFFFF.......C.......F....FFFFFFEF..XWWWWWWWWW
WWWWWWWWWFÈDXEFFFFF.......YYY............FFFFFEXFÈFWWWWWWWWW
WWWWWWWWWDDXFEFFFF.......CYIYC......C.....FFFFEFXDDWWWWWWWWW
WWWWÊWWWWXD.FEFFF.........YYY......YYY.....FFFEF..XWWWWWWWWW
WWWWWWWWWD.ÉFEFF...........C......CYIYC.....FFEFÉ.DWWWWWWWWW
WWWWWWWWWFFFFEF....................YYY.......FEFFFFWWWÊWWWWW
WWWWWWWWWEEEEE.....C.......1...F....C.........EEEEEWWWWWWWWW
WWWWWWWWWEDDDB....CYC.........FF..............BDDDEWWWWWWWWW
WWWWWWWWWEDDDB.....C.....1...FFF..............BDDDEWWWWWWWWW
WWWWWWWWWEDD.T................FF....F.........T.D7EWWWWWWWWW
WWWWWWWWWE6............1.......F....FF....C......DEWWWWWWWWW
WWWWWWWWWE...............C..........FFF..CYC.....7EWWWWWWWWW
WWWWWWÊWWE6..........1..CIC.........FF....C.......EWWWWWWWWW
WWWWWWWWWE...............C..........F...2........7EWWÊWWWWWW
WWWWWWWWWE6........1..............C...............EWWWWWWWWW
WWWWWWWWWE.......C.....F.........CIC..2..........7EWWWWWWWWW
WWWWWWWWWE6.....CYC...FF..........C...............EWWWWWWWWW
WWWWWWWWWED......C...FFF....F.......2............7EWWWWWWWWW
WWWWWWWWWE6D.T........FF....FF................T.DDEWWWWWWWWW
WWWWWWWWWEDDDB.........F....FFF...2.....C.....BDDDEWWWWWWWWW
WWWWWWWWWEDDDB..............FF.........CYC....BDDDEWWWWWWWWW
WWWWWWWWWEEEEE.........C....F...2.......C.....EEEEEWWWWÊWWWW
WWWWWWWWWFFFFEF.......YYY....................FEFFFFWWWWWWWWW
WWWWWWÊWWD.ÉFEFF.....CYIYC......C...........FFEFÉ.DWWWWWWWWW
WWWWWWWWW..XFEFFF.....YYY......YYY.........FFFEFX..WWWWWWWWW
WWWWWWWWWDÈ.XEFFFF.....C......CYIYC.......FFFFEX.ÈDWWWWWWWWW
WWWWWWWWWF.FFEFFFFF............YYY.......FFFFFEFF.FWWWWWWWWW
WWWWWWWWWX.ÈDEFFFFFF....F.......C.......FFFFFFEDÈ.XWWWWWWWWW
WWWWWWWWWWFDFEEEEEEEE..FFF.........F...EEEEEEEEFDFWWWWWWWWWW
WWWWWWWWWWXD.FF.FFFFE.FFFFF........FF..EFFFF.FF.DXWWWWWWWWWW
WWWWWWWWWWWFDÈ.É.FÉDEFFFFFFF.......FFF.EDÉ.FÉ.ÈDFWWWWWWWWWWW
WWWWWWWWWWWWWFD.MD.DEEEEEEEEEEEEEEEEEEEED.DM.DFWWWWWWWWWWWWW
WWWWWWWWWWWWWWWWWWWWWWWWWWWWWWWWWWWWWWWWWWWWWWWWWWWÊWWWWWWWW
WWWWWWWWWWWWWWWWWWWWWWWWWWWWWWWWWWWWWWWWWWWWWWWWWWWWWWWWWWWW
WWWWWWWWWWÊWWWWWWWWWWWWWWWWWWÊWWWWWWWWWWWWWWWWWWWWWWWWWWWWWW
WWWWWWWWWWWWWWWWWWWWWWWWWWWWWWWWWWWWWWWWWWWWWWWWWWWWWWWWWWWW
WWWWWWWWWWWWWWWWWWWWWWWWWWWWWWWWWWWWWWWWÊWWWWWWWWWWWWWWWWWWW
WWWWWWWWWWWWWWWWWWWWÊWWWWWWWWWWWWWWWWWWWWWWWWWWWWWWWWWWWWWWW
WWWWWWWWWWWWWWWWWWWWWWWWWWWWWWWWWWWWWWWWWWWWWWWWWWWWWWWWWWWW
WWWWWWWWWWWWWWWWWWWWWWWWWWWWWWWWWWWWWWWWWWWWWWWWWWWWWWWWWWWW
WWWWWWWWWWWWWWWWWWWWWWWWWWWWWWWWWWWWWWWWWWWWWWWWWWWWWWWWWWWW
WWWWWWWWWWWWWWWWWWWWWWWWWWWWWWWWWWWWWWWWWWWWWWWWWWWWWWWWWWWW
WWWWWWWWWWWWWWWWWWWWWWWWWWWWWWWWWWWWWWWWWWWWWWWWWWWWWWWWWWWW
WWWWWWWWWWWWWWWWWWWWWWWWWWWWWWWWWWWWWWWWWWWWWWWWWWWWWWWWWWWW