WWWWWWWWWWWWWWWWWWWWWWWWWWWWWWWWWWWWWWWWWWWWWWWWWWWWWWWWWWWW
WWWWWWWWWWWWWWWWWWWWWWWWWWWWWWWWWWWWWWWWWWWWWWWWWWWWWWWWWWWW
WWWWWWWWWWWWWWWWWWWWWWWWWWWWWWWWWWWWWWWWWWWWWWWWWWWWWWWWWWWW
WWWWWWWWWWWWWWWWWWWWWWWWWWWWWWWWWWWWWWWWWWWWWWWWWWWWWWWWWWWW
WWWWWWWWWWWWWWWWWWWWWWWWWWWWWWWWWWWWWWWWWWWWWWWWWWWWWWWWWWWW
WWWWWWWWWWWWWWWWWWWWWWWWWWWWWWWWWWWWWWWWWWWWWWWWWWWWWWWWWWWW
WWWWWWWWWWWWWWWWWWWWWWWWWWWWWWWWWWWWWWWWWWWWWWWWWWWWWWWWWWWW
WWWWWWWWWWWWWWWWWWWWWWWWWWWWWWWWWWWWWWWWWWWWWWWWWWWWWWWWWWWW
WWWWWWWWWWWWWWWWWWWWWWWWWWWWWWWWWWWWWWWWWWWWWWWWWWWWWWWWWWWW
WWWWWWWWWWWWWWWWWWWWWWWWWWWWWWWWWWWWWWWWWWWWWWWWWWWWWWWWWWWW
WWWWWWWWWWWWWWWWWWWWWWWWWWWWWWWWWWWWWWWWWWWWWWWWWWWWWWWWWWWW
WWWWWWWWWWWWWWWWWWWWWWWWWWWWWWWWWWWWWWWWWWWWWWWWWWWWWWWWWWWW
WWWWWWWWWWWWWWWD....D.DD.....FF.D..D....D...DWWWWWWWWWWWWWWW
WWWWWWWWWWWWW.DDFXD.….....….FFFF.....…...DXFF..WWWWWWWWWWWWW
WWWWWWWWWWW».»FFXFFD..DFD..FFFFFFDFFD..DFDFFXF».»WWWWWWWWWWW
WWWWWWWWW»..XEEEEEEEEEEEEEEEEEEEEEEEEEEEEEEEEEEX..»WWWWWWWWW
WWWWWWWW..F»FEXXFFXDD.DDDDFFFFFFFFFFFD.DDDXXXXEF»..DWWWWWWWW
WWWWWWWDF.F.XEXFF..........FFFFFFFFF........XXE.FF..DWWWWWWW
WWWWWWW..»..FEFF............FFFFFFFF..DD.....XEX.F»….WWWWWWW
WWWWWWD.…..»FEF..............FFFFFFFMMM......DE.».F..DWWWWWW
WWWWWWFFF»...ED....DFFF......XXFFFFFFF.......DEM...F..WWWWWW
WWWWW.D.M..XFED...DMFFFX......XXFFFFF........XEFXX»F»..WWWWW
WWWWWDF»FEEEEED...MXFFFXX......XXFFF.........DEEEEEF.FXWWWWW
WWWWF.F.FEDD.DD..XX..FFFF.....................DDDDEF».F.WWWW
WWWWDF».XE....D..X....FFFF.......................DEF.»F.WWWW
WWWW.F.»FED..B...M...1.FFF..............MD....B..7EX.F.DWWWW
WWWW.XF.ME6..T..........FFF...........2.XM...DT..DE.».X.WWWW
WWWWF..»FED..B.......1..FFF.............DMX...B..7EX.F.FWWWW
WWWWF»..FE6...D.........MXX...........2..D........EM..»DWWWW
WWWWF.F.XED..........1..DMX......MD..............7EF»..FWWWW
WWWWDD.»FE6..............DM......XMD..2..........DEM.FFFWWWW
WWWWF.».MED.......D..1....D......XXM.........D...7EF».FFWWWW
WWWWF..»FE6..BD..XMD.............FFF..2......DB..DEX..DFWWWW
WWWW..FFFE...TD...MX.1...........FFF..........T..7EF.».FWWWW
WWWWF»..FE6..B....DM..............FFF.2...X...B..DEF».X.WWWW
WWWWX.F».ED.......................FFFF....M..D....EXF».FWWWW
WWWWD.F.MED.DD.....................FFFF..XM...DD.DEM.FF.WWWW
WWWWW»..FEEEEE..........FFFXX......XXFFFXMD...EEEEEF».XWWWWW
WWWWW.F».»..XEX........FFFFFXX......XFFFMD...DEM.X»..FDWWWWW
WWWWWWX.F..»MED.......FFFFFFFXX......FFFD....DEF»..F».WWWWWW
WWWWWWD..»...ED......MMMFFFFFFF..............FEX.F.F..WWWWWW
WWWWWWW»F.F.XEX.....DD.DFFFFFFFF............FFEF..»F.WWWWWWW
WWWWWWW....»FEXX........FFFFFFFFF..........FFXEF».F.DWWWWWWW
WWWWWWWW.…...EXXXXDDD.DFFFFFFFFFFF.DDD.DDXFFXXE..…..WWWWWWWW
WWWWWWWWWD.F»EEEEEEEEEEEEEEEEEEEEEEEEEEEEEEEEEE»..DWWWWWWWWW
WWWWWWWWWWWD.»FXFFD..DFFDFFFFFFFFDFD.DFFD.FXFF»..WWWWWWWWWWW
WWWWWWWWWWWWW.DFXD.…......FFFFF.....….....DFFX.WWWWWWWWWWWWW
WWWWWWWWWWWWWWWD......D....FFF..D......D....DWWWWWWWWWWWWWWW
WWWWWWWWWWWWWWWWWWWWWWWWWWWWWWWWWWWWWWWWWWWWWWWWWWWWWWWWWWWW
WWWWWWWWWWWWWWWWWWWWWWWWWWWWWWWWWWWWWWWWWWWWWWWWWWWWWWWWWWWW
WWWWWWWWWWWWWWWWWWWWWWWWWWWWWWWWWWWWWWWWWWWWWWWWWWWWWWWWWWWW
WWWWWWWWWWWWWWWWWWWWWWWWWWWWWWWWWWWWWWWWWWWWWWWWWWWWWWWWWWWW
WWWWWWWWWWWWWWWWWWWWWWWWWWWWWWWWWWWWWWWWWWWWWWWWWWWWWWWWWWWW
WWWWWWWWWWWWWWWWWWWWWWWWWWWWWWWWWWWWWWWWWWWWWWWWWWWWWWWWWWWW
WWWWWWWWWWWWWWWWWWWWWWWWWWWWWWWWWWWWWWWWWWWWWWWWWWWWWWWWWWWW
WWWWWWWWWWWWWWWWWWWWWWWWWWWWWWWWWWWWWWWWWWWWWWWWWWWWWWWWWWWW
WWWWWWWWWWWWWWWWWWWWWWWWWWWWWWWWWWWWWWWWWWWWWWWWWWWWWWWWWWWW
WWWWWWWWWWWWWWWWWWWWWWWWWWWWWWWWWWWWWWWWWWWWWWWWWWWWWWWWWWWW
WWWWWWWWWWWWWWWWWWWWWWWWWWWWWWWWWWWWWWWWWWWWWWWWWWWWWWWWWWWW
WWWWWWWWWWWWWWWWWWWWWWWWWWWWWWWWWWWWWWWWWWWWWWWWWWWWWWWWWWWW