WWWWWWWWWWWWWWWWWWWWWWWWWWWWWWWWWWWWWWWWWWWWWWWWWWWWWWWWWWWW
WWWWWWWWWWWWWWWWWWWWWWWWWWWWWWWWWWWWWWWWWWWWWWWWWWWWWWWWWWWW
WWWWWWWWWWWWWWWWWWWWWWWWWWWWWWWWWWWWWWWWWWWWWWWWWWWWWWWWWWWW
WWWWWWWWWWWWWWWWWWWWWWWWWWWWWWWWWWWWWWWWWWWWWWWWWWWWWWWWWWWW
WWWWWWWWWWWWWWWWWWWWWWWWWWWWWWWWWWWWWWWWWWWWWWWWWWWWWWWWWWWW
WWWWWWWWWWWWWWWWWWWWWWWWWWWWWWWWWWWWWWWWWWWWWWWWWWWWWWWWWWWW
WWWWWWÊWWWWWWWWWWWWWWWWWWWWWWWWWWWWWWWWWWWWWWWWWWWWÊWWWWWWWW
WWWWWWWWWWWWWWWWWWWWWWWWWWWWÊWWWWWWWWWWWWWWWWWWWWWWWWWWWWWWW
WWWWWWWWWWWWWWWWWWWWWWWWWWWWWWWWWWWWWWWWWWWWWWWWWWWWWWWWWWWW
WWWWWWWWWWWWWWWWWWWWWWWWWWWWWWWWWWWWWWWWWWWWWWWWWWWWWWWWWWWW
WWWWWWWWWWWWWWWWWÊWWWWWWWWD.FFFFFDWWWWWWWWWWWWWWWWWWWWWWWWWW
WWWWWWWWWWWWWWWWWWWWWWWWWM.É.FF.É.DWWWWWWWWÊWWWWWWWWWWWWWWWW
WWWWWWWWWWWWWWWWWWWWWWWWFXFDDFFXDDFDWWWWWWWWWWWWWWWWWWWWWWWW
WWWWWWWWWWWWWWWWWWWWWFMEEEEEEEEEEEEEEFFWWWWWWWWWWWWWWWWWWWWW
WWWWWWWWWWWWWWWWWWFEEEEEFFFFFMMFFFFFEEEEEWWWWWWWWÊWWWWWWWWWW
WWWWWWWWÊWWWWWWWFEEE..FFFFFFFXXFFFFFFF.DEEEFWWWWWWWWWWWWWWWW
WWWWWWWWWWWWFFXEEE.DFFFFFFD.BXXBDDFFFFFFD.EEEWWWWWWWWWWWWWWW
WWWWWWWWWWFFÈMEED..FFFF...............FFF.DDEEFÉWWWWWWWWWWWW
WWWWWWWWWW...FE...FF....................FF...EFFFFWWWWWWWWWW
WWWWWWWWWW.Ë.EE..FF.....DD...FF....D.....FF.DEE.ÈXWWWWWWWWWW
WWWWWWWWWF...ED........XMMXFFFFFFXMMX.........EXFDWWWWWWWWWW
WWWWWWWWWMFFXE.........FFFFFFFFFFFFFF.........EFFFMWWWWWWWWW
WWWWWWWWWEEEEE........FFF.DDD...D..FFF........EEEEEWWWWWWWWW
WWWWWWWWWEDDDY...T...FF....D.........FF...T...Y.DDEWWWWWWWWW
WWWWWWÊWWE..DY.......F.......D........F.......Y...EWWWWWWWWW
WWWWWWWWWE...........1....BXX..XXB...............7EWWÊWWWWWW
WWWWWWWWWE6.............FFF......FFF..2...........EWWWWWWWWW
WWWWWWWWWE.......F...1..FF........FF......F......7EWWWWWWWWW
WWWWWWWWWE6....BFF.....FF..........FF.2...FFB....DEWWWWWWWWW
WWWWWWWWWE.....XFF...1.FF..........FF.....FFX....7EWWWWWWWWW
WWWWWWWWWE6....XFF.....FF..........FF.2...FFX.....EWWWWWWWWW
WWWWWWWWWE.....BFF...1.FF..........FF.....FFB....7EWWWWWWWWW
WWWWWWWWWE6......F......FF........FF..2...F......DEWWWWWWWWW
WWWWWWÊWWE...........1..FFF......FFF.............7EWWÊWWWWWW
WWWWWWWWWE6.............D.BXX..XXB....2...........EWWWWWWWWW
WWWWWWWWWE...Y.......F...........D....F.......Y...EWWWWWWWWW
WWWWWWWWWEDD.Y...T...FF..............FF...T...YD..EWWWWWWWWW
WWWWWWWWWEEEEE........FFF..........FFF.......DEEEEEWWWWWWWWW
WWWWWWWWWFF.FED........FFFFFFFFFFFFFF........DEFXFFWWWWWWWWW
WWWWWWWWWMDÉ.E.........XMMXFFFFFFXMMX.........EXÈ.FWWWWWWWWW
WWWWWWWWWFDDXEE..FF....D.D...FF...DD.....FF.DEED.XDWWWWWWWWW
WWWWWWWWWFXXÈFED..FF....................FF.DDEX.Ë.WWWWWWWWWW
WWWWWWWWWWFFMDEED..FFF...............FFFF.D.EEF...WWWWWWWWWW
WWWWWWWWWWWWFFXEEE..FFFFFFDDBXXB.DFFFFFFD.EEEMDD.FWWWWWWWWWW
WWWWWWWWWWWWWWWFFEEE..FFFFFFFXXFFFFFFF..EEEFXFDFWWWWWWWWWWWW
WWWWWWWWWWWWWWWWWWWEEEEEFFFFFMMFFFFFEEEEEMFWWWWWWWWWWWWWWWWW
WWWWWWWWWWWWWWWWWWWWWWFEEEEEEEEEEEEEEFWWWWWWWWWWWWWWWWWWWWWW
WWWWWWWWWWWWWWÊWWWWWWWWWDXFFMFFFXXMFWWWWWWWWWWÊWWWWWWWWWWWWW
WWWWWWWWWWWWWWWWWWWWWWWWWWFDÉ.FMFMWWWWWWWWWWWWWWWWWWWWWWWWWW
WWWWWWWWWWWWWWWWWWWWWÊWWWWWDFFFWWWWWWWÊWWWWWWWWWWWWWWWWWWWWW
WWWWWWWWWWWWWWWWWWWWWWWWWWWWWWWWWWWWWWWWWWWWWWWWWWWWWWWWWWWW
WWWWWWWWWWWWWWWWWWWWWWWWWWWWWWWWWWWWWWWWWWWWWWWWWWWWWWWWWWWW
WWWWWÊWWWWWWWWWWWWWWWWWWWWWWWWWWWWWWWWWWWWWWWWWWWWWWWWWWWWWW
WWWWWWWWWWWWWWWWWWWWWWWWWWWWWWWWWWWWWWWWWWWWWWWWWWWWWWWWWWWW
WWWWWWWWWWWWWWWWWWWWWWWWWWWWWWWWWWWWWWWWWWWWWWWWWWWWWWÊWWWWW
WWWWWWWWWWWWWWWWWWWWWWWWWWWWWWWWWWWWWWWWWWWWWWWWWWWWWWWWWWWW
WWWWWWWWWWWWWWWWWWWWWWWWWWWWWWWWWWWWWWWWWWWWWWWWWWWWWWWWWWWW
WWWWWWWWWWWWWWWWWWWWWWWWWWWWWWÊWWWWWWWWWWWWWWWWWWWWWWWWWWWWW
WWWWWWWWWWWWWWWWWWWWWWWWWWWWWWWWWWWWWWWWWWWWWWWWWWWWWWWWWWWW
WWWWWWWWWWWWWWWWWWWWWWWWWWWWWWWWWWWWWWWWWWWWWWWWWWWWWWWWWWWW