WWWWWWWWWWWWWWWWWWWWWWWWWWWWWWWWWWWWWWWWWWWWWWWWWWWWWWWWWWWW
WWWWWWWWWWWWWWWWWWWWWWWWWWWWWWWWWWWWWWWWWWWWWWWWWWWWWWWWWWWW
WWWWWWWWWWWWWWWWWWWWWWWWWWWWWWWWWWWWWWWWWWWWWWWWWWWWWWWWWWWW
WWWWWWWWWWWWWWWWWWWWWWWWWWWWWWWWWWWWWWWWWWWWWWWWWWWWWWWWWWWW
WWWWWWWWWWWWWWWWWWWWWWWWWWWWWWWWWWWWWWWWWWWWWWWWWWWWWWWWWWWW
WWWWWWWWWWWWWWWÊWWWWWWWWWWWWWWWWWWWWWWWWWWWWWWWWWWWWWWWWWWWW
WWWWWWWWWWWWWWWWWWWWWWWWWWWWWWWWWWWWWWWWWWWWWWWWWWWWWWWWWWWW
WWWWWWWWWWWWWWWWWWWWWWWWWWWWWWWWWWWWWWWWWWWWWWWWWWWWWWWWWWWW
WWWWWWWWWWWWWWWWWWWWWWWWWWWWWWWWWWWWWWWWWWWWWWWWWWWWWWWWWWWW
WWWWWWWWWWWWWWWWWWWWWWWWÊWWWWWWWWWWWWWWWWWWWWWWWWWWWWWWWWWWW
WWWWWWWWWWWWWWWWWWWWWWWWWWWWWWWWWWWWWWWWWWWWWWWWWWWWWWWWWWWW
WWWWWWWWWWWÊWWWWWWWEEEEEEEEEEEWWÊWWWWWWWWWWWWWWWWWWÊWWWWWWWW
WWWWWWWWWWWWWWWWWWEEFFFFFFFFFEEWWWWWWWWWWWWWWWWWWWWWWWWWWWWW
WWWWWWWWWWWWWEEEEEEFFFFFFFFFFFEEEEEEEEEWWWÊWWWWWWWWWWWWWWWWW
WWWWWWWWWWWWWEFFFF.............D...D.DEEWWWWWWWWWWWWWWWWWWWW
WWWWWWWWWWWWWEFFFF....................DEEEEEEWWWWWWWWWWWWWWW
WWWWWWWWWFFFFE..FF.....III..............FFFFEÈFFFWWWWWWWWWWW
WWWWWWWWWFFFÈED.FF.....BBB..............FFFFEFFÈFWWWWWWWWWWW
WWWWWWWWWFF..EM.FF......................FF..EFFFFWWWWWWWWWWW
WWWWÊWWFFF.ËFEMXFF...............XXM....FF.DEÉFFFWWÊWWWWWWWW
WWWWWWWFÈF..FEX.FF......................FF..E.FFFWWWWWWWWWWW
WWWWWWWFFFFFFE..FF......................FF..EFFFFWWWWWWWWWWW
WWWWWFFFFEEEEE..FF......................FF..EEEEEEEFFFFWWWWW
WWWWWF.FFE..DD..FF.......aaa............FFFF.DD..DEF.FFFWWWW
WWWWWF..FED.....FF.........a........2...FFFF......E.È.FFWWWW
WWWWWFÈ.FE......FFa........a............MMFF....7.EF...FWWWW
WWWWWF..FE.6....FFa........a........2.....FF.....DEF.Ë.FWWWW
WWWWWFFFFE......FFa....1...II.............FF....7.EF...FWWWW
WWÊWWFFÈ.E.6....FF..................2.....FF......EFÈ.FFWWWW
WWWWWFF..E......FF.....1..................FF....7.EF..FWWWWW
WWWWFFFFFE.6....FF..................2.....FF......EFFFFWWWWW
WWWWF.FFFED.....FF.....1..................FF....7.EFF.FWWÊWW
WWWWF..FFE.6....FF.............II...2....aFF.....DEF.ÈFWWWWW
WWWWFÈ.FFE......FF.....1........a........aFF....7.E...FWWWWW
WWWWF...FE.6....FFMM............a........aFF......E.Ë.FWWWWW
WWWWFFF.FE......FFFF...1........a.........FF......E...FWWWWW
WWWWFF.È.ED..D..FFFF............aaa.......FF.....DEFFFFWWWWW
WWWWWWWFFEEEEEEE..FF......................FF..EEEEEFFFFWWWWW
WWWWWWWFÈFFFFFFED.FF......................FF..EFFFFÉFWWWWWWW
WWWWÊWWFFFÉFFEFE..FF......................FF.MEF.ÈFFFWWWWWWW
WWWWWWWWFFFFFÈFED.FF....XXM...............FFMMEÉ..FFFWWWWWWW
WWWWWWWWWWWFFEFED.FF......................FF.XEFFFFWWWWÊWWWW
WWWWWWWWWWWFÉEFEFFFF..............BBB.....FF.DEÈFFFWWWWWWWWW
WWWWWWWWWWWFFFFEFFFF..............III.....FF..EFFFFWWWWWWWWW
WWWWWWWWWWWFFFFEEEEEED....................FFFFEWWWWWWWWWWWWW
WWWWWWWWWWWWWWWWWWWWEED..D................FFFFEWWWWWWWWWWWWW
WWWWWWWWWWWWWWWWWWWWWEEEEEEEEEFFFFFFFFFFFEEEEEEWWÊWWWWWWWWWW
WWWWWWWWWWWWÊWWWWWÊWWWWWWWWWWEEFFFFFFFFFEEWWWWWWWWWWWWWWWWWW
WWWWWWWWWWWWWWWWWWWWWWWWWWWWWWEEEEEEEEEEEWWWWWWWWWWWWWWWWWWW
WWWWWWWWWWWWWWWWWWWWWWWWÊWWWWWWWWWWWWWWWWWWWWWWWWWWWWWWWWWWW
WWWWWWWWWWWWWWWWWWWWWWWWWWWWÊWWWWWWWWWWWWWWWWWWWWWWWWWWWWWWW
WWWWWWWWWWWWWWWWWWWWWWWWWWWWWWWWWWWWWWÊWWWWWWWWWWWWWWWWWWWWW
WWWWWWWWWWWWWWWWWWWWWWWWWWWWWWWWWWWWWWWWWWWWWWWWWWWWWWWWWWWW
WWWWWWWWWWWWWWWWWWÊWWWWWWWWWWWWWWWWWWWWWWWWWWWWWWÊWWWWWWWWWW
WWWWWWWWWWWWWWWWWWWWWWWWWWWWWWWWWWWWWWWWWWWWWWWWWWWWWWWWWWWW
WWWWWWWWWWWWWWWWWWWWWWWWWWWWWWWWWWWWWWWWWWWWWWWWWWWWWWWWWWWW
WWWWWWWWWWWWWWWWWWWWWWWWWWWWWWWWWWWWWWWWWWWWWWWWWWWWWWWWWWWW
WWWWWWWWWWWWWWWWWWWWWWWWWWWWWWWWWWWWWWWWWWWWWWWWWWWWWWWWWWWW
WWWWWWWWWWWWWWWWWWWWWWWWWWWWWWWWWWWWWWWWWWWWWWWWWWWWWWWWWWWW
WWWWWWWWWWWWWWWWWWWWWWWWWWWWWWWWWWWWWWWWWWWWWWWWWWWWWWWWWWWW