WWWWWWWWWWWWWWWWWWWWWWWWWWWWWWWWWWWWWWWWWWWWWWWWWWWWWWWWWWWW
WWWWWWWWWWWWWWWWWWWWWWWWWWWWWWWWWWWWWWWWWWWWWWWWWWWWWWWWWWWW
WWWWWWWWWWWWWWWWWWWWWWWWWWWWWWWWWWWWWWWWWWWWWWWWWWWWWWWWWWWW
WWWWWWWWWWWWWWWWWWWWWWWWWWWWWWWWWWWWWWWWWWWWWWWWWWWWWWWWWWWW
WWWWWWWWWWWWWWWWWWWWWWWWWWWWWWWWWWWWWWWWWWWWWWWWWWWWWWWWWWWW
WWWWWWWWWWWWWWWWWWWWWWWWWWWWWWWWWWWWWWWWWWWWÊWWWWWWWWWWWWWWW
WWWWWWWWWWWWWWWWWWWWWWWWWWWWWWWWWWWWWWWWWWWWWWWWWWWWWWWWWWWW
WWWWWWWWWWWWWWWWWWWWWWWWWWWWWWWWWWWWWWWWWWWWWWWWWWWWWWWWWWWW
WWWWWWWWWWWWWW...FFFWWWWWWWWWWWÊWWWWWWWWWWWWWWWWWWWWWWWWWWWW
WWWWWWWWWWWW..É.FFFFFWWWWWWWWWWWWWWWWWFFTWWWWWWWWWWWWWWWWWWW
WWWWWWWWWWW....ÈFFFFFFWWWWWWWWWWWWWWWWFFFFWWWWWWWWWWWWWWWWWW
WWWWWWWWWWW.È...FFFFFFFFWWWWWWWWWWWWWWMMMMWWWWWWÊWWWWWWWWWWW
WWWWWWWWWW....FFFF.ÈFFFFFWWWWWWWWWWWWWWWWWWWWWWWWWWWWWWWWWWW
WWWWWWWWWW.É.FFFFË..É.FFFWWWWWWWWWWWWWWWWWWWWWWWWWWWWWWWWWWW
WWWWWWWWWWFFFFF.......EEEEEEEEEEEEEEEEWWWWWWWWWWWWWWWWWWWWWW
WWWWWWWWWFFFFFF.È.T..CEB..D.........BEWWWWWWWWWWWWWWWWWWWWWW
WWWWWWWWWFFFÈ..D.TT.YYE..............EWWWWWWWWWWWWWWWWWWWWWW
WWWWWWWWW.FF....EEEEEEE..............EEEEEEETTNNNNNWWWWWWWWW
WWWWWWWWWFFFÉ.TTE..........TXXXXT......D...E....BBNWWWWWWWWW
WWWWWWWWWFFF...TE............BB............E..D.BBNWWWWWWWWW
WWWWWWWWWFFFFF..E..........................EFF....NWWWWWWWWW
WWWWWWWWWWFFFFFFE...NNNN............NNNN...EFFF...NWWWWWWWWW
WWWWWWWWWWWFFFFFE...ND.................N...EFFF....WWWWWWWWW
WWWWWWWWWWWFFEEEE...N......X....X......N...EEEE..D.WWWWWWWWW
WWWWWWWWWWWWWEB.....N......X....X......N.....BE....WWWWWWWWW
WWWWWWWWWWWWWE..........XXXX....XXXX..........EFF.TWWWWWWWWW
WWWWWWWWWWWWWE............D........D..........EFFFTWWWWWWWWW
WWWWWWWWWWWWWE...NC......................YN...EFFFFWWWWWWWWW
WWWWWWWWWWWWWE...N........................N...EFFFFWWWWWWWWW
WWWWWWWWWWWFFE...N....YC.....2......YY....N...EFFFFWWWWWWWWW
WWWWWWWWWWFFFE...N....YY............CY....N...EFFFTWWWWWWWWW
WWWWWWWWWFFF.ED..N........................N...EFF.TWWWWWWWWW
WWWWWWWWWFFF.E...NY......................CN...E....WWWWWWWWW
WWWWWWWWWF.D.E...................D...........DE...NWWWWWWWWW
WWWWWWWWW....E..........XXXX...DXXXX..........E.BBNWWWWWWWWW
WWWWWWWWW....EB.....N....D.X....X......N.....BE.BBNWWWWWWWWW
WWWWWWWWW..È.EEEE...N......X....X......N...EEEENNNNWWWWWWWWW
WWWWWWWWW....FFFE...ND.................N...EWWWWWWWWWWWWWWWW
WWWWWWWWWW..FFFFE...NNNN............NNNN...EWWWWWWWWWWWWWWWW
WWWWWWWWWWXXXFFFE...........1.1.1..........EWWWWWWWWWWWWWWWW
WWWWWWWWWWXC.FFFE..........................EWWWWWWWWWWWWWWWW
WWWWWWWWWWN..FFFE..D.....XXT....TXX......D.EWWWWWWWWWWWWWWWW
WWWWWWWWWWN...FFEEEEEEE..............EEEEEEEWWWWWÊWWWWWWWWWW
WWWWWÊWWWWN...FFFFFFB.E..............E....DWWWWWWWWWWWWWWWWW
WWWWWWWWWWNTFF..FF...ÉEB........D...BE.É...WWWWWWWWWWWWWWWWW
WWWWWWWWWWWFFF........EEEEEEEEEEEEEEEE.....WWWWWWWWWWWWWWWWW
WWWWWWWWWWWWTF.CY.È..FFFFFFFFFFFFFFFFFF..ÈWWWWWWWWWWWWWWWWWW
WWWWWWWWWWWWNNNNXX..FFFFFFFFFFFFFFFFFFFF..WWWWWWWWWWWWWWWWWW
WWWWWWWWWWWWWWWWWXXXXXFF.D.TFFFFT...FFXXWWWWWWWWWWWWWWWWWWWW
WWWWWWWWWWWWWWWWWWWWXXaaaaaaFFFFaaaaaaXXWWWWWWWWWWWWWWWWWWWW
WWWWWWWWWWWWWWWWWWWWWWWWWWWWWWWWWWWWWWWWWWWWWWWWWWWWWWWWWWWW
WWWWWWWWWWWWÊWWWWWWWWWWWWWWWWWWWWWWWWWWWWWWWWWWWWWWWWWWWWWWW
WWWWWWWWWWWWWWWWWWWWWWWWWWWWWWWWWWWWWWWWWWWWWWWWWWWÊWWWWWWWW
WWWWWWWWWWWWWWWWWWWWWWWWWWWWWWWWWWWWWWWWWWWWWWWWWWWWWWWWWWWW
WWWWWWWWWWWWWWWWWWWWWWWÊWWWWWWWWWWWWWWWÊWWWWWWWWWWWWWWWWWWWW
WWWWWWWWWWWWWWWWWWWWWWWWWWWWWWWWWWWWWWWWWWWWWWWWWWWWWWWWWWWW
WWWWWWWWWWWWWWWWWWWWWWWWWWWWWWWWWWWWWWWWWWWWWWWWWWWWWWWWWWWW
WWWWWWWWWWWWWWWWWWWWWWWWWWWWWWWWWWWWWWWWWWWWWWWWWWWWWWWWWWWW
WWWWWWWWWWWWWWWWWWWWWWWWWWWWWWWWWWWWWWWWWWWWWWWWWWWWWWWWWWWW
WWWWWWWWWWWWWWWWWWWWWWWWWWWWWWWWWWWWWWWWWWWWWWWWWWWWWWWWWWWW