FFFFFFFFFFFFFFFFFFFFFFFFFFFFFFFFFFFFFFFFFFFFFFFFFFFFFFFFFFFF
FFFFFFFFFFFFFFFFFFFFFFFFFFFFFFFFFFFFFFFFFFFFFFFFFFFFFFFFFFFF
FFFFFFFFFFFFFFFFFFFFFFFFFFFFFFFFFFFFFFFFFFFFFFFFFFFFFFFFFFFF
FFFFFFFFFFFFFFFFFFFFFFFFFFFFFFFFFFFFFFFFFFFFFFFFFFFFFFFFFFFF
FFFFFFFFFFFFFFFFFFFFFFFFFFFFFFFFFFFFFFFFFFFFFFFFFFFFFFFFFFFF
FFFFFFFFFFFFFFFFFFFFFFFFFFFFFFFFFFFFFFFFFFFFFFFFFFFFFFFFFFFF
FFFFFFFFFFFFFFFFFFFFFFFFFFFFFFFFFFFFFFFFFFFFFFFFFFFFFFFFFFFF
FFFFFFFFFFFFFFFFFFFFFFFFFFFFFFFFFFFFFFFFFFFFFFFFFFFFFFFFFFFF
FFFFFFFFFFFFFFFFFFFFFFFFFFFFFFFFFFFFFFFFFFFFFFFFFFFFFFFFFFFF
FFFFFFFFFFFFFFFFFFFFFFFFFFFFFFFFFFFFFFFFFFFFFFFFFFFFFFFFFFFF
FFFFFFFFFFFFFFFFFFFFFFFFFMFFFFFMFFFFFFFFFFFFFFFFFFFFFFFFFFFF
FFFFFFFFFFFFFFFFFFFFFFFFFMMMMMMMFFFFFFFFFFFFFFFFFFFFFFFFFFFF
FFFFFFFFFFFFFFFFFFFTTFFFFFFFBBFFFFFTTFFFFFFFFFFFFFFFFFFFFFFF
FFFFFFFFFFFFFFFFFFFTTFFFFFFFFFFFFFFTTFFFFFFFFFFFFFFFFFFFFFFF
FFFFFFFFFFFFFFFFFFFFFFFFFFFFFFFFFFFFFFFFFFFFFFFFFFFFFFFFFFFF
FFFFFFFFFFFFMMFFFFFFFFFFFFFFFFFFFFFFFFFFFFFFFFFFFFFFFFFFFFFF
FFFFFFFFFFFFMMYFFFFFFFFFFFFFFFFFFFFFFFFFFFFFCMMFFFFFFFFFFFFF
FFFFFFFFFFFFFYFFEEEEEEEEEEFFYYYFFEEEEEEEEEEFFMMFFFFFFFFFFFFF
FFFFFFFFFFFFFFFFE........EEEEEEEEE........EFFCFFFMFFFFFFFFFF
FFFFFFFFFFFFFFFFE........BBBEEEBBB........EFFFFFFMCFFFFFFFFF
FFFFFFFFFFFFFFFEE..CC.................CC..EEFFFFFMMMFFFFFFFF
FFFFFFFFFMFFFFFE...YY.................YY...ECCFFFFFFFFFFFFFF
FFFFFFFFFMTFFFFE.......M.....2.....M.......ECCFFFFFFFFFFFFFF
FFFFFFFFFMTFFFEE......DM...........M.......EEFFFFFFFFFFFFFFF
FFFFFFFFFMMFFFED.....MMM...........MMM.....DEFFFFFFXXXFFFFFF
FFFFFFFFFFFFFFE.............NNN.............EFFFFFFBBXFFFFFF
FFFFFFFFFFFCCEE...............D.............EEFFFFFBBXFFFFFF
FFFFFFFFFFFCCE...............................EFFFFFFFXFFFFFF
FFFFFFFFFFFFEE...X......BX..WWW..XB......X...EEFFFFFFFFFFFFF
FFFFFFFFFFFFEE...MMM...MMMD.WWW..MMM...MMMD..EEFFFFFFFFFFFFF
FFFFFFFFFFFFEE...X......BX..WWW..XB......X...EEFFFFFFFFFFFFF
FFFFFFFFFFFFFE...............D...............ECCFFFFFFFFFFFF
FFFFFXFFFFFFFEE.............................EECCFFFFFFFFFFFF
FFFFFXBBFFFFFFED............NNN......D......EFFFFFFFFFFFFFFF
FFFFFXBBFFFFFFE......MMM.....T.....MMM......EFFFFFFFFFFFFFFF
FFFFFXXXXFFFFFEE.......M...........M.......EEFFFFMMFFFFFFFFF
FFFFFFFFFFFFFCCE.......M...........M.......EFFFFFTMFFFFFFFFF
FFFFFFFFFFFFFCCE...CC......1.1.1......CC...EFFFFFTMFFFFFFFFF
FFFFFFFFFFFFFFFEE..YY.................YY..EEFFFFFFMFFFFFFFFF
FFFFFFFFFFFFFFFFE.........................EFFFFFFFFFFFFFFFFF
FFFFFFFMMMFFFFFFE......D...........D......EFFFFFFFFFFFFFFFFF
FFFFFFFFCMFFFFCFEEEEEEEEEEEEEEEEEEEEEEEEEEEFFFFFFFFFFFFFFFFF
FFFFFFFFFMFFFMMCFFFFFFFFFFFFYYYFFFFFFFFFFFFFFFYFFFFFFFFFFFFF
FFFFFFFFFFFFFMMFFFFFFYYFFFFFFFFFFFFFYYFFFFFFFYMMFFFFFFFFFFFF
FFFFFFFFFFFFFFFFFFFFFFFFFFFFFFFFFFFFFFFFFFFFFFMMFFFFFFFFFFFF
FFFFFFFFFFFFFFFFFFFFFFFFFFFFFFFFFFFFFFFFFFFFFFFFFFFFFFFFFFFF
FFFFFFFFFFFFFTTTFFFFFFFFFFFFFFFFFFFFFFFFFFFFFFFFFFFFFFFFFFFF
FFFFFFFFFFFFFFFFFFFFFCCFFFFFYYYFFFFFCCFFFFFFFFFFFFFFFFFFFFFF
FFFFFFFFFFFFFFFFFFFFFCCFFFFFYYYFFFFFCCFFFFFFFFFFFFFFFFFFFFFF
FFFFFFFFFFFFFFFFFFFFXXXXXMMMMMMMMMXXXXXFFFFFFFFFFFFFFFFFFFFF
FFFFFFFFFFFFFFFFFFFFFFXXXMMMMMMMMMXXXFFFFFFFFFFFFFFFFFFFFFFF
FFFFFFFFFFFFFFFFFFFFFFFFFFFFFFFFFFFFFFFFFFFFFFFFFFFFFFFFFFFF
FFFFFFFFFFFFFFFFFFFFFFFFFFFFFFFFFFFFFFFFFFFFFFFFFFFFFFFFFFFF
FFFFFFFFFFFFFFFFFFFFFFFFFFFFFFFFFFFFFFFFFFFFFFFFFFFFFFFFFFFF
FFFFFFFFFFFFFFFFFFFFFFFFFFFFFFFFFFFFFFFFFFFFFFFFFFFFFFFFFFFF
FFFFFFFFFFFFFFFFFFFFFFFFFFFFFFFFFFFFFFFFFFFFFFFFFFFFFFFFFFFF
FFFFFFFFFFFFFFFFFFFFFFFFFFFFFFFFFFFFFFFFFFFFFFFFFFFFFFFFFFFF
FFFFFFFFFFFFFFFFFFFFFFFFFFFFFFFFFFFFFFFFFFFFFFFFFFFFFFFFFFFF
FFFFFFFFFFFFFFFFFFFFFFFFFFFFFFFFFFFFFFFFFFFFFFFFFFFFFFFFFFFF
FFFFFFFFFFFFFFFFFFFFFFFFFFFFFFFFFFFFFFFFFFFFFFFFFFFFFFFFFFFF