WWWWWWWWWWWWWWWWWWWWWWWWWWWWWWWWWWWWWWWWWWWWWWWWWWWWWWWWWWWW
WWWWWWWWWWWWWWWWWWWWWWWWWWWWWWWWWWWWWWWWWWWWWWWWWWWWWWWWWWWW
WWWWWWWWWWWWWWWWWWWWWWWWWWWWWWWWWWWWWWWWWWWWWWWWWWWWWWWWWWWW
WWWWWWWWWWWWWWWWWWWWWWWWWWWWWWWWWWWWWWWWWWWWWWWWWWWWWWWWWWWW
WWWWWWWWWWWWWWWWWWWWWWWWWWWWWWWWWWWWWWWWWWWWWWWWWWWWWWWWWWWW
WWWWWWWWWW WWWWWWWW..aaaaa...WWWWWaaaaaWWWWWWWWWWWWWWWWWWWWW
WWWWWWWWWWWWWWWW...D.......….XXX....F...WWWWWWWWWWWWWWWWWWWW
WWWWWWWWWWWWWWWW..FFFFFFFFF..MMM.…FFFF...WWWWWWWWWWWWWWWWWWW
WWWWWWWWWWWWWWWW.FFF..FFFFFFFFFFFFFFFF.......DWWWWWWWWWWWWWW
WWWWWWWWWWWWWWWW.FFF.EEEEEEEEEEEEEEEEE..FFFFF..WWWW WWWWWWWW
WWWWWW WWWWWWWW.FFF».E..............DE.»..FFFF.WWWWWWWWWWWWW
WWWWWWWWWWWWWW..FF...E.D.............E.....FFFFWWWWWWWWWWWWW
WWWWWWWWWWWWWD....EEEE...............EEEE...FFF.WWWWWWWWWWWW
WWWWWWWWWWWW....À.EBB.....MM...MM.....BBETT.FFF..WWWWWWWWWWW
WWWWWWWWWWWWFFF...EBB.................BBETT..FF...WWWWWWWWWW
WWWWWWWWWWW.FFFEEEE.....................EEEE.ÀF.D.WWWWWWWWWW
WWWWWWWWWWWW.FFE.............2.............E.....WWWWWWWWWWW
WWWWWWWWWWWW.FFE......C.............Y......EFF..WWWWWWWWWWWW
WWWWWWWWWWW..FFE......TTT.........TTT......EFF..WWWWWWWWWWWW
WWWWWWWWWWW.…FFE.......D............D......EFFF.WWWWWWWWWWWW
WWWWWWWWWW..FFFE...........................EFFF.aWWWW WWWWWW
WWWWWWWWWW..FFFE...........................EFFF.aWWWWWWWWWWW
WWWWW WWWW..FF»E........CYD......YC........EFFF.aWWWWWWWWWWW
WWWWWWWWWWWaFFFENNN.....CY......DYC.....NNNE»FFFaWWWWWWWWWWW
WWWWWWWWWWWaFFFETD........................TEFFFF..WWWWWWWWWW
WWWWWWWWWWWaFFFE...........................EFFFF..WWWWWWWWWW
WWWWWWWWWWWaFFFE...........................EFFFF..WWWWWWWWWW
WWWWWWWWWWW.FFFE......NNN.........NNND.....EFFF..WWWWWWWWWWW
WWWWWWWWWWW.»FFE......Y.............C.....DEFF»..WWWWWWWWWWW
WWWWWWWWWW.....E...........................E.....WWWW WWWWWW
WWWWWWWWWW.NNNNEEEE......D..............EEEENNNN.WWWWWWWWWWW
WWWWWWWWWWW.FF....EBB....MMF...FMM....BBE........WWWWWWWWWWW
WWWWWWWWWWWWFF.….FEBB..D.XXF...FXXD...BBE..…..F...WWWWWWWWWW
WWWWWWWWWWWWWF...FEEEEEEEEEE..EEEEEEEEEEE...FFF..WWWWWWWWWWW
WWWWWWWWWWWWWFFFFFYYYFFFFEEE..EEEFFFFFCCC.FFFFF..WWWWWWWWWWW
WWWWWWW WWWWWFFFFF...FFFFEBB..BBEFFFFF....FFF..WWWWWWWWWWWWW
WWWWWWWWWWWWWD.FFFFFF..FFEBB..BBEFF.F..D.FF..WWWWWWWW WWWWWW
WWWWWWWWWWWWW...FFFF..À.FEBB..BBEFFÀ.......WWWWWWWWWWWWWWWWW
WWWWWWWWWWWWWW...FF.....FEBB..BBEFFFF.....WWWWWWWWWWWWWWWWWW
WWWWWWWWWWWWWWWW....D..FFEBB..BBEFFFF....WWWWWWWWWWWWWWWWWWW
WWWWWWWWWWWWWWWWWWWa...»FEEB..BEEFF»F.D..WWWW WWWWWWWWWWWWWW
WWWWWWWWWWWWWWWWWWWa.…FFFFEB..BEFFFFFFN..WWWWWWWWWWWWWWWWWWW
WWWWWWWWWWWWWWWWWWWa..FFFFEB..BEFFFFFFN...WWWWWWWWWWWWWWWWWW
WWWWWWWWWWWWWW WWWWa..FFEEEB..BEEEFFFFN....aWWWWWWWWWWWWWWWW
WWWWWWWWWWWWWWWWWWWa.FFFEBBB..BBBEFFFFNNNN.aWWWWWWWWWWWWWWWW
WWWWWWWWWWWWWWWWWW..FFFFE........EFFFF..FF.aWWWWWWWWWWWWWWWW
WWWWWWWWWWWWWWWWWW....FFE..1.1.1.EFFFF..FF.aWWWWWWWWWWWWWWWW
WWWWWWWWWWWWWWWWWWW...FFE........EFFFF...….aWWWWWWWWWWWWWWWW
WWWWWWWWWWWWWWWWWWW..»FFEEEEEEEEEEFFF»....WWWWWWWWWWWWWWWWWW
WWWWWWWWWWWWWWWWWWW...FFFFFFFFFFFFFFF....WWWWWWWWWWWWWWWWWWW
WWWWWWWWWWWWWWWWWWW.FFFFFFFFFFFFFFFFF..….WWWWWWWWWWWWWWWWWWW
WWWWWWWWWWWWWWWWWWWW.FF.…..........FFF...WWWWWWWWWWWWWWWWWWW
WWWWWWWWWWWWWWW WWWWW.....aaaaaaa….FFFF.WWWW WWWWWWWWWWWWWWW
WWWWWWWWWWWWWWWWWWWWWWW...WWWWWWW...FFF.WWWWWWWWWWWWWWWWWWWW
WWWWWWWWWWWWWWWWWWWWWWWWWWWWWWWWWWWWWWWWWWWWWWWWWWWWWWWWWWWW
WWWWWWWWWWWWWWWWWWWWWWWWWWWWWWWWWWWWWWWWWWWWWWWWWWWWWWWWWWWW
WWWWWWWWWWWWWWWWWWWWWWWWWWWWW WWWWWWWWWWWWWWWWWWWWWWWWWWWWWW
WWWWWWWWWWWWWWWWWWWWWWWWWWWWWWWWWWWWWWWWWWWWWWWWWWWWWWWWWWWW
WWWWWWWWWWWWWWWWWWWWWWWWWWWWWWWWWWWWWWWWWWWWWWWWWWWWWWWWWWWW
WWWWWWWWWWWWWWWWWWWWWWWWWWWWWWWWWWWWWWWWWWWWWWWWWWWWWWWWWWWW