WWWFFF..2.2.2..FFFFWW
WWWFFF.........FFFFWW
WWWFFFFFFFFFFMMFFFFWW
WWWFFFMMFFFFFMMFFFFWW
WWWFFFMMFFFFFMMFFFFWW
WWWFFFFFFFFFFFFFFFFMM
WWWFFFFFFFFFFFFFFFFMM
WWWFFFFFFFFFFFFFFFFFF
WWWFFFFMFFFFFFFFFFFFF
WWMFFFMMFFFFFMMMFFFFF
MMMFFFMMFFFFFMMMFFFFF
MMMFFFMMFFFFFFFFFFFFF
FFFFFFFXFFFFFFFFFFFFF
FFFFFFFXXXFFFFFFFFFFF
FFFFFFFF.....FFFFFFFF
FFFFFFFF.....MMMFFFMM
MMFFFMMM.....MMMFFFMM
MMFFFMMM.....FFFFFFFF
FFFFFFFF.....FFFFFFFF
FFFFFFFFFFFXXXFFFFFFF
FFFFFFFFFFFFFXFFFFFFF
FFFFFFFFFFFFFMMFFFMMM
FFFFFMMMFFFFFMMFFFMMM
FFFFFMMMFFFFFMMFFFMWW
FFFFFFFFFFFFFMFFFFWWW
FFFFFFFFFFFFFFFFFFWWW
MMFFFFFFFFFFFFFFFFWWW
MMFFFFFFFFFFFFFFFFWWW
WWFFFFMMFFFFFMMFFFWWW
WWFFFFMMFFFFFMMFFFWWW
WWFFFFMMFFFFFFFFFFWWW
WWFFFF.........FFFWWW
WWFFFF..1.1.1..FFFWWW