WWWWWWWWWWWWWWWWWWWWWWWWWWWWWWWWWWWWWWWWWWWWWWWWWWWWWWWWWWWW
WWWWWWWWWWWWWWWWWWWWWWWWWWWWWWWWWWWWWWWWWWWWWWWWWWWWWWWWWWWW
WWWWWWWWWWWWWWWWWWWWWWWWWWWWWWWWWWWWWWWWWWWWWWWWWWWWWWWWWWWW
WWWWWWWWWWWWWWWWWWWWWWWWWWWWWWWWWWWWWWWWWWWWWWWWWWWWWWWWWWWW
WWWWWWWWWWWWWWWWWWWWWWWWWWWWWWWWWWWWWWWWWWWWWWWWWWWWWWWWWWWW
WWWWWWWWWWWWWWWWWWWWWWWWWWWWWWWWWWWWWWWWWWWWWWWWWWWWWWWWWWWW
WWWWWWÊWWWWWWWWWWWWWWWWWWWWWWWWWWWWWWWWWWWWWWWWWWWWÊWWWWWWWW
WWWWWWWWWWWWWWWWWWWWWWWWWWWWÊWWWWWWWWWWWWWWWWWWWWWWWWWWWWWWW
WWWWWWWWWWWWWWWWWWWWWWWWWWWWWWWWWWWWWWWWWWWWWWWWWWWWWWWWWWWW
WWWWWWWWWWWWWWWWWWWWWWWWWWWWWWWWWWWWWWWWWWWWWWWWWWWWWWWWWWWW
WWWWWWWWWWWWWWWWWÊWWWWWWWWD.FFFFFDWWWWWWWWWWWWWWWWWWWWWWWWWW
WWWWWWWWWWWWWWWWWWWWWWWWWM.É.FF.É.DWWWWWWWWÊWWWWWWWWWWWWWWWW
WWWWWWWWWWWWWWWWWWWWWWWWFXFDDFFXDDFDWWWWWWWWWWWWWWWWWWWWWWWW
WWWWWWWWWWWWWWWWWWWWWWWFFFFFFFFFFFFFWWWWWWWWWWWWWWWWWWWWWWWW
WWWWWWWWWWWWWWWWWWWWT.É.FFFFFFFFFFF......WWWWWWWWÊWWWWWWWWWW
WWWWWWWWÊWWWWWWWW........ÈFFFFFFFT.É...È..WWWWWWWWWWWWWWWWWW
WWWWWWWWWWWWFF.....EEEEEEEEEEEEEEEEEEEEEEÈWWWWWWWWWWWWWWWWWW
WWWWWWWWWWFFÈM....ÈEB...XMMMFFFFMMMMX..BE.....FÉWWWWWWWWWWWW
WWWWWWWWWW...FEEEEEE.......XFFFF...X....EEEEEEFFFFWWWWWWWWWW
WWWWWWWWWW.Ë.EY.............FFFF.............YE.ÈXWWWWWWWWWW
WWWWWWWWWF...EY.............FFFF.............YEXFDWWWWWWWWWW
WWWWWWWWWMFFXEYD........YYYY......D....D.....YEFFFMWWWWWWWWW
WWWWWWWWWEEEEEYY........CB.....YYYC.........YYEEEEEWWWWWWWWW
WWWWWWWWWED..B.................CB.............B..DEWWWWWWWWW
WWWWWWÊWWE...B........D.....FFFF..........D...B...EWWWWWWWWW
WWWWWWWWWE...Y....1.......FFFFFFFF............Y..7EWWÊWWWWWW
WWWWWWWWWE6..Y.........Y.FFFFFFFFFF.C....2....Y...EWWWWWWWWW
WWWWWWWWWE.........1.NNNNFFFDII.FFFNNNN..........7EWWWWWWWWW
WWWWWWWWWE6....FF.......FFF......FFFD...2..FF.....EWWWWWWWWW
WWWWWWWWWE.....FXY1.....FFF......FFF......CXF....7EWWWWWWWWW
WWWWWWWWWE6....FXC......FFF......FFF.....2YXF.....EWWWWWWWWW
WWWWWWWWWE.....FF..1...DFFF......FFF.......FF....7EWWWWWWWWW
WWWWWWWWWE6..........NNNNFFF.IIDFFFNNNN.2.........EWWWWWWWWW
WWWWWWÊWWE...Y....1....C.FFFFFFFFFF.Y.........Y..7EWWÊWWWWWW
WWWWWWWWWE6..Y............FFFFFFFF.......2....Y...EWWWWWWWWW
WWWWWWWWWE...B...D..........FFFF.....D........B...EWWWWWWWWW
WWWWWWWWWED..B.............BC.................B...EWWWWWWWWW
WWWWWWWWWEEEEEYY.........CYYY.....BC........YYEEEEEWWWWWWWWW
WWWWWWWWWFF.FEY.....D....D......YYYY........DYEFXFFWWWWWWWWW
WWWWWWWWWMDÉ.EY.............FFFF.............YEXÈ.FWWWWWWWWW
WWWWWWWWWFDDXEY.............FFFF.............YED.XDWWWWWWWWW
WWWWWWWWWFXXÈFEEEEEE....X...FFFFX.......EEEEEEX.Ë.WWWWWWWWWW
WWWWWWWWWWFFMD.....EB..XMMMMFFFFMMMX...BEÈ....F...WWWWWWWWWW
WWWWWWWWWWWWFFWWWWÈEEEEEEEEEEEEEEEEEEEEEE.....DDWWWWWWWWWWWW
WWWWWWWWWWWWWWWWWW..È...É.TFFFFFFFÈ........WWWWWWWWWWWWWWWWW
WWWWWWWWWWWWWWWWWWW......FFFFFFFFFFF.É.TWWWWWWWWWWWWWWWWWWWW
WWWWWWWWWWWWWWWWWWWWWWWWFFFFFFFFFFFFFWWWWWWWWWWWWWWWWWWWWWWW
WWWWWWWWWWWWWWÊWWWWWWWWWDXFFMFFFXXMFWWWWWWWWWWÊWWWWWWWWWWWWW
WWWWWWWWWWWWWWWWWWWWWWWWWWFDÉ.FMFMWWWWWWWWWWWWWWWWWWWWWWWWWW
WWWWWWWWWWWWWWWWWWWWWÊWWWWWDFFFWWWWWWWÊWWWWWWWWWWWWWWWWWWWWW
WWWWWWWWWWWWWWWWWWWWWWWWWWWWWWWWWWWWWWWWWWWWWWWWWWWWWWWWWWWW
WWWWWWWWWWWWWWWWWWWWWWWWWWWWWWWWWWWWWWWWWWWWWWWWWWWWWWWWWWWW
WWWWWÊWWWWWWWWWWWWWWWWWWWWWWWWWWWWWWWWWWWWWWWWWWWWWWWWWWWWWW
WWWWWWWWWWWWWWWWWWWWWWWWWWWWWWWWWWWWWWWWWWWWWWWWWWWWWWWWWWWW
WWWWWWWWWWWWWWWWWWWWWWWWWWWWWWWWWWWWWWWWWWWWWWWWWWWWWWÊWWWWW
WWWWWWWWWWWWWWWWWWWWWWWWWWWWWWWWWWWWWWWWWWWWWWWWWWWWWWWWWWWW
WWWWWWWWWWWWWWWWWWWWWWWWWWWWWWWWWWWWWWWWWWWWWWWWWWWWWWWWWWWW
WWWWWWWWWWWWWWWWWWWWWWWWWWWWWWÊWWWWWWWWWWWWWWWWWWWWWWWWWWWWW
WWWWWWWWWWWWWWWWWWWWWWWWWWWWWWWWWWWWWWWWWWWWWWWWWWWWWWWWWWWW
WWWWWWWWWWWWWWWWWWWWWWWWWWWWWWWWWWWWWWWWWWWWWWWWWWWWWWWWWWWW