WWWWWWWWWWWWWWWWWWWWWWWWWWWWWWWWWWWWWWWWWWWWWWWWWWWWWWWWWWWW
WWWWWWWWWWWWWWWWWWWWWWWWWWWWWWWWWWWWWWWWWWWWWWWWWWWWWWWWWWWW
WWWWWWWWWWWWWWWWWWWWWWWWWWWWWWWWWWWWWWWWWWWWWWWWWWWWWWWWWWWW
WWWWWWWWWWWWWWWWWWWWWWWWWWWWWWWWWWWWWWWWWWWWWWWWWWWWWWWWWWWW
WWWWWWWWWWWWWWWWWWWWWWWWWWWWWWWWWWWWWWWWWWWWWWWWWWWWWWWWWWWW
WWWWWWWWWWWWWWWWWWWWWWWWWWWWWWWWWWWWWWWWWWWWWWWWWWWWWWWWWWWW
WWWWWWÊWWWWWWWWWWWWWWWWWWWWWWWWWWWWWWWWWWWWWWWWWWWWÊWWWWWWWW
WWWWWWWWWWWWWWWWWWWWWWWWWWWWÊWWWWWWWWWWWWWWWWWWWWWWWWWWWWWWW
WWWWWWWWWWWWWWWWWWWWWWWWWWWWWWWWWWWWWWWWWWWWWWWWWWWWWWWWWWWW
WWWWWWWWWWWWWWWWWWWWWWWWWWWWWWWWWWWWWWWWWWWWWWWWWWWWWWWWWWWW
WWWWWWWWWWWWWWWWWÊWWWWWWWWD.FFFFFDWWWWWWWWWWWWWWWWWWWWWWWWWW
WWWWWWWWWWWWWWWWWWWWWWWWWM.É.FF.É.DWWWWWWWWÊWWWWWWWWWWWWWWWW
WWWWWWWWWWWWWWWWWWWWWWWWFXFDDFFXDDFDWWWWWWWWWWWWWWWWWWWWWWWW
WWWWWWWWWWWWWWWWWWWWWFMFFFF.È.MM.FFFFFFWWWWWWWWWWWWWWWWWWWWW
WWWWWWWWWWWWWWWWWWFFFFFFFFFF.MMFFFFFFFFFFWWWWWWWWÊWWWWWWWWWW
WWWWWWWWÊWWWWEEEEEEEEEEEEEEEEEEEEEEEEEEEEEEEEEEWWWWWWWWWWWWW
WWWWWWWWWWWWFE...FFFFFF....MMMMMM.........MXXXEWWWWWWWWWWWWW
WWWWWWWWWWFFÈE...FFFFFF....MMMMMM...........TXEÉWWWWWWWWWWWW
WWWWWWWWWW...E...............MM..............MEFFFWWWWWWWWWW
WWWWWWWWWW.Ë.EX..............MM...............E.ÈXWWWWWWWWWW
WWWWWWWWWF...EMM....................YYYFF.....EXFDWWWWWWWWWW
WWWWWWWWWMFFXE........MMMM...........FFFF.....EFFFMWWWWWWWWW
WWWWWWWWWEEEEE........MXFFFFFF................EEEEEWWWWWWWWW
WWWWWWWWWEDDDY...........FFFFFFF..............Y.DDEWWWWWWWWW
WWWWWWÊWWE..DY....M.......FFNNNNN........M....Y...EWWWWWWWWW
WWWWWWWWWE........M..1....FFN............M.......7EWWÊWWWWWW
WWWWWWWWWE6......TM.........N.........2..MX.......EWWWWWWWWW
WWWWWWWWWE......YYY..1............YC.....YYY.....7EWWWWWWWWW
WWWWWWWWWE6.......................Y...2..........DEWWWWWWWWW
WWWWWWWWWE...........1............C..............7EWWWWWWWWW
WWWWWWWWWE6..............C............2...........EWWWWWWWWW
WWWWWWWWWE...........1...Y.......................7EWWWWWWWWW
WWWWWWWWWE6.....YYY.....CY............2..YYY.....DEWWWWWWWWW
WWWWWWÊWWE.......XM..1.........N.........MT......7EWWÊWWWWWW
WWWWWWWWWE6.......M............NFF....2..M........EWWWWWWWWW
WWWWWWWWWE...Y....M........NNNNNFF.......M....Y...EWWWWWWWWW
WWWWWWWWWEDD.Y..............FFFFFFF...........YD..EWWWWWWWWW
WWWWWWWWWEEEEE................FFFFFFXM........EEEEEWWWWWWWWW
WWWWWWWWWFF.FE.....FFFF...........MMMM........EFXFFWWWWWWWWW
WWWWWWWWWMDÉ.E.....FFYYY....................MMEXÈ.FWWWWWWWWW
WWWWWWWWWFDDXE.........D.....MM..............XED.XDWWWWWWWWW
WWWWWWWWWFXXÈEM..............MM...............E.Ë.WWWWWWWWWW
WWWWWWWWWWFFMEXT...........MMMMMM....FFFFFF...E...WWWWWWWWWW
WWWWWWWWWWWWFEXXXM.........MMMMMM....FFFFFF...ED.FWWWWWWWWWW
WWWWWWWWWWWWWEEEEEEEEEEEEEEEEEEEEEEEEEEEEEEEEEEFWWWWWWWWWWWW
WWWWWWWWWWWWWWWWWWWFFFFFFFFFFMM.FFFFFFFFFMFWWWWWWWWWWWWWWWWW
WWWWWWWWWWWWWWWWWWWWWWFFFFF.MM.È.FFFFFWWWWWWWWWWWWWWWWWWWWWW
WWWWWWWWWWWWWWÊWWWWWWWWWDXFFMFFFXXMFWWWWWWWWWWÊWWWWWWWWWWWWW
WWWWWWWWWWWWWWWWWWWWWWWWWWFDÉ.FMFMWWWWWWWWWWWWWWWWWWWWWWWWWW
WWWWWWWWWWWWWWWWWWWWWÊWWWWWDFFFWWWWWWWÊWWWWWWWWWWWWWWWWWWWWW
WWWWWWWWWWWWWWWWWWWWWWWWWWWWWWWWWWWWWWWWWWWWWWWWWWWWWWWWWWWW
WWWWWWWWWWWWWWWWWWWWWWWWWWWWWWWWWWWWWWWWWWWWWWWWWWWWWWWWWWWW
WWWWWÊWWWWWWWWWWWWWWWWWWWWWWWWWWWWWWWWWWWWWWWWWWWWWWWWWWWWWW
WWWWWWWWWWWWWWWWWWWWWWWWWWWWWWWWWWWWWWWWWWWWWWWWWWWWWWWWWWWW
WWWWWWWWWWWWWWWWWWWWWWWWWWWWWWWWWWWWWWWWWWWWWWWWWWWWWWÊWWWWW
WWWWWWWWWWWWWWWWWWWWWWWWWWWWWWWWWWWWWWWWWWWWWWWWWWWWWWWWWWWW
WWWWWWWWWWWWWWWWWWWWWWWWWWWWWWWWWWWWWWWWWWWWWWWWWWWWWWWWWWWW
WWWWWWWWWWWWWWWWWWWWWWWWWWWWWWÊWWWWWWWWWWWWWWWWWWWWWWWWWWWWW
WWWWWWWWWWWWWWWWWWWWWWWWWWWWWWWWWWWWWWWWWWWWWWWWWWWWWWWWWWWW
WWWWWWWWWWWWWWWWWWWWWWWWWWWWWWWWWWWWWWWWWWWWWWWWWWWWWWWWWWWW