WWWWWWWWWWWWWWWWWWWWWWWWWWWWWWWWWWWWWWWWWWWWWWWWWWWWWWWWWWWW
WWWWWWWWWWWWWWWWWWWWWWWWWWWWWWWWWWWWWWWWWWWWWWWWWWWWWWWWWWWW
WWWWWWWWWWWWWWWWWWWWWWWWWWWWWWWWWWWWWWWWWWWWWWWWWWWWWWWWWWWW
WWWWWWWWWWWWWWWWWWWWWWWWWWWWWWWWWWWWWWWWWWWWWWWWWWWWWWWWWWWW
WWWWWWWWWWWWWWWWWWWWWWWWWWWWWWWWWWWWWWWWWWWWWWWWWWWWWWWWWWWW
WWWWWWWWWWWWWWWWWWWWWWWWWWWWWWWWWWWWWWWWWWWWWWWWWWWWWWWWWWWW
WWWWWWÊWWWWWWWWWWWWWWWWWWWWWWWWWWWWWWWWWWWWWWWWWWWWÊWWWWWWWW
WWWWWWWWWWWWWWWWWWWWWWWWWWWWÊWWWWWWWWWWWWWWWWWWWWWWWWWWWWWWW
WWWWWWWWWWWWWWWWWWWWWWWWWWWWWWWWWWWWWWWWWWWWWWWWWWWWWWWWWWWW
WWWWWWWWWWWWWWWWWWWWWWWWWWWWWWWWWWWWWWWWWWWWWWWWWWWWWWWWWWWW
WWWWWWWWWWWWWWWWWÊWWWWWWWWD.FFFFFDWWWWWWWWWWWWWWWWWWWWWWWWWW
WWWWWWWWWWWWWWWWWWWWWWWWWM.É.FF.É.DWWWWWWWWÊWWWWWWWWWWWWWWWW
WWWWWWWWWWWWWWWWWWEEEEEEEEEEEEEEEEEEEEEEEEWWWWWWWWWWWWWWWWWW
WWWWWWWWWWWWWWWWWWE..........TMMTD......DEWWWWWWWWWWWWWWWWWW
WWWWWWWWWWWWWWWWWWE...........XX.........EWWWWWWWÊWWWWWWWWWW
WWWWWWWWÊWWWWWWEEEED.....D...............EEEEWWWWWWWWWWWWWWW
WWWWWWWWWWWWFF.EFFF......................FFFEWWWWWWWWWWWWWWW
WWWWWWWWWWFFÈM.EFF......YCD...FF.C........FFEFFÉWWWWWWWWWWWW
WWWWWWWWWW...F.EF........YYYY.FF.YYYY......FEFFFFFWWWWWWWWWW
WWWWWWWWWW.Ë.EEE...........Y..FF.YY.........EEE.ÈXWWWWWWWWWW
WWWWWWWWWF...E.........1......................EXFDWWWWWWWWWW
WWWWWWWWWMFFXE......................2...D.....EFFFMWWWWWWWWW
WWWWWWWWWEEEEE....FFD....Y....FF........FF....EEEEEWWWWWWWWW
WWWWWWWWWE...YC...FF.....IYYFFFF..IY....FF...CY...EWWWWWWWWW
WWWWWWÊWWE..DYY..........ICFFFF..DID.........YY..DEWWWWWWWWW
WWWWWWWWWE...B.......1..CI.FFF...CI...........B..7EWWÊWWWWWW
WWWWWWWWWE6........C.......FF...YYY...2...........EWWWWWWWWW
WWWWWWWWWE.........Y........D....DYY.............7EWWWWWWWWW
WWWWWWWWWE6....C...Y..............Y.........Y.....EWWWWWWWWW
WWWWWWWWWE.....IFF.C...1..................FFI....7EWWWWWWWWW
WWWWWWWWWE6....IFF..................2...C.FFI.....EWWWWWWWWW
WWWWWWWWWE.....Y.........Y..............Y...C....7EWWWWWWWWW
WWWWWWWWWE6.............YYD....D........Y.........EWWWWWWWWW
WWWWWWÊWWE...........1...YYY...FF.......C........7EWWÊWWWWWW
WWWWWWWWWE6..B...........IC...FFF.IC..2.......B...EWWWWWWWWW
WWWWWWWWWED..YY.........DID..FFFFCI..........YYD..EWWWWWWWWW
WWWWWWWWWE...YC...FF....YI..FFFFYYI.....FF...CY...EWWWWWWWWW
WWWWWWWWWEEEEE....FF........FF....Y....DFF....EEEEEWWWWWWWWW
WWWWWWWWWFF.FE.....D...1......................EFXFFWWWWWWWWW
WWWWWWWWWMDÉ.E......................2.........EXÈ.FWWWWWWWWW
WWWWWWWWWFDDXEEE.......D.YY.FF..Y...........EEED.XDWWWWWWWWW
WWWWWWWWWFXXÈFFEF......YYYY.FF.YYYY........FE.X.Ë.WWWWWWWWWW
WWWWWWWWWWFFMDFEFF........C.FF...DCY......FFE.F...WWWWWWWWWW
WWWWWWWWWWWWFFXEFFF......................FFFE.DD.FWWWWWWWWWW
WWWWWWWWWWWWWWWEEEE...............D.....DEEEEFDFWWWWWWWWWWWW
WWWWWWWWWWWWWWWWWWE.........XX...........EWWWWWWWWWWWWWWWWWW
WWWWWWWWWWWWWWWWWWED......DTMMT..........EWWWWWWWWWWWWWWWWWW
WWWWWWWWWWWWWWWWWWEEEEEEEEEEEEEEEEEEEEEEEEWWWWÊWWWWWWWWWWWWW
WWWWWWWWWWWWWWWWWWWWWWWWWWFDÉ.FMFMWWWWWWWWWWWWWWWWWWWWWWWWWW
WWWWWWWWWWWWWWWWWWWWWÊWWWWWDFFFWWWWWWWÊWWWWWWWWWWWWWWWWWWWWW
WWWWWWWWWWWWWWWWWWWWWWWWWWWWWWWWWWWWWWWWWWWWWWWWWWWWWWWWWWWW
WWWWWWWWWWWWWWWWWWWWWWWWWWWWWWWWWWWWWWWWWWWWWWWWWWWWWWWWWWWW
WWWWWÊWWWWWWWWWWWWWWWWWWWWWWWWWWWWWWWWWWWWWWWWWWWWWWWWWWWWWW
WWWWWWWWWWWWWWWWWWWWWWWWWWWWWWWWWWWWWWWWWWWWWWWWWWWWWWWWWWWW
WWWWWWWWWWWWWWWWWWWWWWWWWWWWWWWWWWWWWWWWWWWWWWWWWWWWWWÊWWWWW
WWWWWWWWWWWWWWWWWWWWWWWWWWWWWWWWWWWWWWWWWWWWWWWWWWWWWWWWWWWW
WWWWWWWWWWWWWWWWWWWWWWWWWWWWWWWWWWWWWWWWWWWWWWWWWWWWWWWWWWWW
WWWWWWWWWWWWWWWWWWWWWWWWWWWWWWÊWWWWWWWWWWWWWWWWWWWWWWWWWWWWW
WWWWWWWWWWWWWWWWWWWWWWWWWWWWWWWWWWWWWWWWWWWWWWWWWWWWWWWWWWWW
WWWWWWWWWWWWWWWWWWWWWWWWWWWWWWWWWWWWWWWWWWWWWWWWWWWWWWWWWWWW