WWWWWWWWWWWWWWWWWWWWWWWWWWWWWWWWWWWWWWWWWWWWWWWWWWWWWWWWWWWW
WWWWWWWWWWWWWWWWWWWWWWWWWWWWWWWWWWWWWWWWWWWWWWWWWWWWWWWWWWWW
WWWWWWWWWWWW..WWWWWWWWWWWWWWWWWWWW.DWWWWWWWWWWWWWWWWWWWWWWWW
WWW.....WWWW..WWWWWWW...JJWWWWWWWWD.WWWW...FFWWWWWWWWWWWWWWW
WWW.DJT.WWWWWWWWWWWWW.DDTJWWWWWWWWWWWWWW..DFFWWWWWWWWWWWWWWW
WWW.JJJ.WWWWWWWW........JJ....D...D........D.WWWWWWWWWWWWWWW
WWW.TJJ.WWWWWWWW.EEEEEEEEEEEEEEEEEEEEEEEEEJT.WWWWWWWWWWWWWWW
WWW.....WWWWWWWW.EFFFFFFF.цбббббц.FFFFFFFEJJ.WWW....WWWWWWWW
WWWWWWWWWWWWWWJJJEFFFFFFF.ббааабб.FFFFFFFE.WWWWW.TD.WWWWWWWW
WWWWWWWWWWWWWWJTJEFF......цба4абц......FFE.WWWWW.D..WWWWWWWW
WWWWWWWWWWWWWWJJJEFF...................FFE.WWWWW....WWWWWWWW
WWWWWWWWWWWWWW.D.EFF...................FFEDWWWWWWWWWWWWWWWWW
WWWWWWWWWWWWWW...E.......................EDWWWWWWWWWWWWWWWWW
WWWWWWWWWWWWWWWW.EббII..WWW.....WWW..FFббE.WWWWWWWWWWWWWWWWW
WWWWWWWWFF.D.WWW.Eбб....WWW2.2.2WWW..FFббETWWWWWWWWWWWWWWWWW
WWWWWWWWFFDD.WWW.Eюю....WWW.....WWW..IIююE.....WWWWWWWW...WW
WWWWWWWW...D.WWWDEWW....абц.....цба....WWE..DT.WWWWWWWW...WW
WWWWWWWW.DT..WWW.EWW....абб..9..бба....WWE.D.D.WWWWWWWW...WW
WWWWWWWW.....WWWDEWW....абц.....цба....WWE..T..WWWWWWWWWWWWW
WWWWWWWWWWWWWWWW.Eааю...FFF.....FFF...юааE.....WWWWWWWWWWWWW
WWWWWWWWWWWWWWWWTEбаю...FFF.....FFF...юабE.WWWWWWWWWWWWWWWWW
WWWWWWWWWWWWWWWW.Eааю...FFF.....FFF...юааE.WWWWWWWWWWWWWWWWW
WWWWWWWWWWWWWWWW.EWW....юбцII...цбю....WWE.WWWWWWWWWWWWWWWWW
WWWWWWWWWWWWWWWW.EWW....юбб.....ббю....WWE.WWWWWWWWWWWWWWWWW
WWWWWWWWWWWWWWWW.EWW....ююю....Dююю....WWE.WWWWW...FFWWWWWWW
WWWWWWWWWWWWW....EааFF..WWW.....WWWBBIIббE.WWWWWDTJFFWWWWWWW
WWFFFFWWWWWWW.DT.EааFF.DWWW..DD.WWW....ббE...WWWDJJJ.WWWWWWW
WWFFFFWWWWWWW..D.EююIIBBWWW.D...WWW....ююE.D.WWWF.JT.WWWWWWW
WWFF..WWWWWWW.T..EWW..........D.....D..WWE.D.WWWFFD..WWWWWWW
WWFF..WWWWWWW....EWW.D...D.D.I..D.D..D.WWEJT.WWWWWWWWWWWWWWW
WWWWWWWWWWWWWWWW.EWW.....D..DI...D.....WWEJJ.WWWWWWWWWWWWWWW
WWWWWWWWWWWWWWWW.EWW...D.......D.......WWE.WWWWWWWWWWWWWWWWW
WWWWWWWWWWWW..WW.Eюю....WWW..D..WWWBBIIабEDWWWWWWWWWWWWWWWWW
WWWWWWWWWWWW.TWW.Eаа....WWW.DD..WWW..FFааE.WWWWWWWWWWWWWWWWW
WWWWWWWWWWWWWWWW.EбаIIBBWWW.....WWW..FFююE.WWWWWWWWWWWWWWWWW
WWWWWWWWWWWWWWWW.EWW....юаб.....ююю....WWEDWWWWD.WWWWWWWWWWW
WWWWWWWWWWWWWWWW.EWW....юбб.....юаа....WWEDWWWW..WWWWWW...WW
WWWWWW.....WWWWW.EWW....абб...IIюаб....WWE.WWWWWWWWWWWW.T.WW
WWWWWW.TJD.WWWWW.Eбаб...FFF.....FFF...юаюE.WWWWWWWWWWWW...WW
WWWWWW.JJJ.WWWWW.Eаюа...FFF.....FFF...абаE.WWWWWWWWWWWWWWWWW
WWWWWW.DJT.WWWWW.Eбаб...FFF.....FFF...юаюE....WWWWWWWWWWWWWW
WWWWWW.....WWWWW.EWW....юаб.....баю....WWE..T.WWWWWWWWWWWWWW
WWWWWWWWWWWWWWWJJEWW....абб..8..бба....WWE..D.WWWWWWWWWWWWWW
WWWWWWWWWWWWWWWTJEWW....ббц.....цбб....WWE.D..WWWWWWWWWWWWWW
WWWWWWWWWWWWWWW.DEббII.................ббE....WWWWWWWWWWWWWW
WWWWWWWWWWWWWWWD.EббFF.....1.1.1.......ююETWWWWWWWWWWWWWWWWW
WWWWWWWWWWWWWWW..EббFF...............IIббEDWWWWWWWWWWWWWWWWW
WWWWWWWWWWD.WWWW.E.......................EDWWWWWWWWWWWWWWWWW
WWWWWWWWWW.DWWWW.EFF...................FFE.WWWWWWWWWW..FFWWW
WWWWWWWWWWWWWWWW.EFF...................FFE.WWWT.WWWWW.DDFWWW
WWWWWWWWWWWWWWWW.EFF......цба4абц......FFE.WWW.DWWWWW.DT.WWW
WWWWWWWWWWWWWWWW.EFFFFFFF.ббааабб.FFFFFFFE..WWWWWWWWW....WWW
WWWWWWWWWWWWWW..JEFFFFFFF.цбббббц.FFFFFFFE.DWWWWWWWWWWWWWWWW
WWW...WWWWWWWW.TJEEEEEEEEEEEEEEEEEEEEEEEEEJ.WWWWWWWWWWWWWWWW
WWW..DWWWWWWWW.DJJ.....DD....DJJ.DDD.....DTDWWWWWWWWWWWWWWWW
WWW...WWWWWWWW.DDT.WWWWWWWW...TJWWWWWWW.....WWWWWWWWWWWWWWWW
WWWWWWWWWWWWWW.....WWW..WWWWWWWWWWWWWWWWWWWWWWWW.D.WWWWWWWWW
WWWWWWWWWWWWWWWWWWWWWW.TWWWWWWWWWWWWD.WWWWWWWWWWDT.WWWWWWWWW
WWWWWWWWWWWWWWWWWWWWWWWWWWWWWWWWWWWWT.WWWWWWWWWW...WWWWWWWWW
WWWWWWWWWWWWWWWWWWWWWWWWWWWWWWWWWWWWWWWWWWWWWWWWWWWWWWWWWWWW