WWWWWWWWWWWWWWWWWWWWWWWWWWWWWWWWWWWWWWWWWWWWWWWWWWWWWWWWWWWW
WWWWWWWWWWWWWWWWWWWWWWWWWWWWWWWWWWWWWWWWWWWWWWWWWWWWWWWWWWWW
WWWWWWWWWWWWWWWWWWWWWWWWWWWWWWWWWWWWFFWWWWWWWWWWWWWWWWWWWWWW
WWWWWWWWWWWWWWWWWWWWWWWWWWWWWWWWWWWFFFFWWWWWWWWWWWWWWWWWWWWW
WWWWWWWWWWWWWWWWWWWWWWWWWWWWWWWWWWWFFFFWWWWWWWWWWWWWWWWWWWWW
WWWWWWWWWWWWWWWWWWWWWWWWWWWWWWWWWWWWFFWWWWWWWWWWWWWWWWWWWWWW
WWWWWWWWWWWWWWWWWWFFFFWWWWWWWWWWWWWWWWWWWWWWWWWWWWWWWWWWWWWW
WWWWWWWWWWWWWWWWFFFFFFFFFWWWWFFFFWWWWWWWFFFFWWWWWWWWWWWWWWWW
WWWWWWWWWWWWWWWFFFFFFFFFFFFFFFFFFFFWWWWFFFFFFWWWWWWWWWWWWWWW
WWWWWWWWWWWWWWF.............................FWWWWWWWWWWWWWWW
WWWWWWWWWWWWWWF.EEEEEEEEEEEEEEEEEEEEEEEEEEE.FFWWWWWWWWWWWWWW
WWWWWWWWWWWWWFF.Eббююааа..цаццц..ббббааюббE.FFWWWWWWWWWWWWWW
WWWWWWWWWWWWWFF.Eббююааа..цаб4б..ббббцаюббE.FFWWWWWWWWWWWWWW
WWWWWWWWWWWWWFF.Eббююааа..цабаб..ббббааюббE.FWWWWWWWWWWWWWWW
WWWWWWWWWWWWWFF.E.........................E.FWWWWWWWWWWWWWWW
WWWWWWWWWWWWWWF.E.........................E.WWWWWWWWWWWWWWWW
WWWWWWWWWWWWWWF.Eцц..абббI.2.2.2..........E.WWWWWWWWWWWWWWWW
WWWWWWWWWWWWWWF.Eцц..абббI...........IIбббE.FWWWWWWWWWWWWWWW
WWWWWWWWWWWWWWW.E....................аабббE.FWWWWWWWWWWWWWWW
WWWWWWWWWWFFWWW.E............9..ббб..бббацE.FFWWWWWWWWWWWWWW
WWWWWWWWWFFFFWW.E.......ааб.....ббб..бцбацE.FFWWWWWWWWWWWWWW
WWWWWWWWWFFFFWW.EббIII..ббцб...бцбб..ббб4.E.FFWWWWWWWWWWWWWW
WWWWWWWWWWFFWWW.Eбббаа..аабб...ббII.......E.FFFWWWWWWWWWWWWW
WWWWWWWWWWWWWWW.E..4аа....................E.FFFWWWWWWWWWWWWW
WWWWWWWWWWWWWWW.E...цц....................E.FFFWWWWWWWWWWWWW
WWWWWWWWWWWWWWF.E...................ббаа..E.FFFWWWWWWWWWWWWW
WWWWWWWWWWWWWWF.E.............ббаа..ббаа..E.FFWWWWWWWWWWWWWW
WWWWWWWWWWWWWWF.E.............ббаа........E.FFWWWWWWWWWWWWWW
WWWWWWWWWWWWWFF.E........III..............E.FFWWWWWWWWWWWWWW
WWWWWWWWWWWWWFF.E.........................E.FWWWWWWWWWWWWWWW
WWWWWWWWWWWWFFF.E..III...............III..E.FWWWWWWWWWWWWWWW
WWWWWWWWWWWWFFF.E.........................E.WWWWWWWWWWWWWWWW
WWWWWWWWWWWWFFF.E..............III........E.WWWWWWWWWWWWWWWW
WWWWWWWWWWWFFFF.E........аабб.............E.WWWFFWWWWWWWWWWW
WWWWWWWWWWWFFFF.E..аабб..аабб.............E.WWFFFFWWWWWWWWWW
WWWWWWWWWWWFFFF.E..аабб...................E.WWFFFFWWWWWWWWWW
WWWWWWWWWWWFFFF.E....................цц...E.WWFFFFWWWWWWWWWW
WWWWWWWWWWWFFFF.E....................аа4..E.WWWFFWWWWWWWWWWW
WWWWWWWWWWWWFFF.E.......IIбб...ббаа..аабббE.WWWWWWWWWWWWWWWW
WWWWWWWWWWWWFFF.E.4ббб..ббцб...бцбб..IIIббE.WWWWWWWWWWWWWWWW
WWWWWWWWWWWWFFF.Eцабцб..ббб.....баа.......E.WWWWWWWWWWWWWWWW
WWWWWWWWWWWWWFF.Eцаббб..ббб..8............E.FWWWWWWWWWWWWWWW
WWWWWWWWWWWWWFF.Eбббаа....................E.FWWWWWWWWWWWWWWW
WWWWWWWWWWWWWWF.EбббII...........Iббба..ццE.FWWWWWWWWWWWWWWW
WWWWWWWWWWWWWWF.E..........1.1.1.Iббба..ццE.FWWWWWWWWWWWWWWW
WWWWWWWWWWWWWWF.E.........................E.FFWWWWWWWWWWWWWW
WWWWWWWWWFFWWWF.E.........................E.FFWWWWWWWWWWWWWW
WWWWWWWWFFFFWWF.Eббюаабббб..бабац..аааююббE.FFFWWWWWWWWWWWWW
WWWWWWWWFFFFWWF.Eббюацбббб..б4бац..аааююббE.FFFWWWWWWWWWWWWW
WWWWWWWWWFFWWWF.Eббюаабббб..цццац..аааююббE.FFFWWWWWWWWWWWWW
WWWWWWWWWWWWWWW.EEEEEEEEEEEEEEEEEEEEEEEEEEE.FFFWWWWWWWWWWWWW
WWWWWWWWWWWWWWW.............................FFFWWWWWWWWWWWWW
WWWWWWWWWWWWWWWWFFFFFFFFWWWWWWWWWWWWFFFFFFFFFFWWWWWWWWWWWWWW
WWWWWWWWWWWWWWWWWWWFFFWWWWWWWWWWWWWWWWFFFFFFFWWWWWWWWWWWWWWW
WWWWWWWWWWWWWWWWWWWWWWWWWWWWFFFWWWWWWWWWFFFWWWWWWWWWWWWWWWWW
WWWWWWWWWWWWWWWWWWWWWWWWWWWFFFFFWWWWWWWWWWWWWWWWWWWWWWWWWWWW
WWWWWWWWWWWWWWWWWWWWWWWWWWWFFFFFWWWWWWWWWWWWWWWWWWWWWWWWWWWW
WWWWWWWWWWWWWWWWWWWWWWWWWWWWFFFWWWWWWWWWWWWWWWWWWWWWWWWWWWWW
WWWWWWWWWWWWWWWWWWWWWWWWWWWWWWWWWWWWWWWWWWWWWWWWWWWWWWWWWWWW
WWWWWWWWWWWWWWWWWWWWWWWWWWWWWWWWWWWWWWWWWWWWWWWWWWWWWWWWWWWW