WWWWWWWWWWWWWWWWWWWWWWWWWWWWWWWWWWWWWWWWWWWWWWWWWWWWWWWWWWWW
WWWWWWWWWWWWWWWWWWWWWWWWWWWWWWWWWWWWWWWWWWWWWWWWWWWWWWWWWWWW
WWWWWWWWWWWWWWWWWWWWWWWWWWWWWWWWWWWWWWWWWWWWWWWWWWWWWWWWWWWW
WWWWWWWWWWWWWWWWWWWWWWWWWWWWWWWWWWWWWWWWWWWWWWWWWWWWWWWWWWWW
WWWWWWWWWWWWWWWWWWWWWWWWWWWFFFFFWWWWWWWWWWWWWWWWWWWWWWWWWWWW
WWWWWWWWWWWWWWWWWWWWWWWWWWWFEEEFWWWWWWWWWWWWWWWWWWWWWWWWWWWW
WWWWWWWWWWWWWWFFFFFWWWWWWWWFEFEFWWWWWWWWWWWWWWWWWWWWWWWWWWWW
WWWWWWWWWWWWWWFEEEFWWWWWWWWFEEEFWWWWWWWWWWWWWWWWWWWWWWWWWWWW
WWWWWWWWWWWWWWFEFEFWWWWWWWWFFFFFWWWWWWWWWWWWWWWWWWWWWWWWWWWW
WWWWWWWWWWWWWWFEEEFWWWWWWWWWWWWWWWWWWWWWWWWWWWWWWWWWWWWWWWWW
WWWWWWWWWWWWWWFFFFFWWWWWWWWWWWWWWWWWWWWWWWWWWWWWWWWWWWWWWWWW
WWWWWWWWWWWWWWWWWWWWWFFFFFFFFFFFFFFFFFFFFFFFFFFFWWWWWWWWWWWW
WWWWWWWWWWWWWWWWWWWWWF..DDDDD....D...DD........FWWWWWWWWWWWW
WWWWWWWFFFFFFFFFFFFFFF.EEEEEEEEEEEEEEEEEEEEEEE.FWWWWWWWWWWWW
WWWWWWWF..D..D...D.DD..E...WWWWW.............E.FWWWWWWWWWWWW
WWWWWWWF.EEEEEEEEEEEEEEE...WWWWW.............E.FWWWWWWWWWWWW
WWWWWWWF.E.................бббюю...цббааббц..EDFWWWWWWWWWWWW
WWWWWWWFDE.................бббаа...аббаабба..EDFWWWWWWWWWWWW
WWWWWWWF.E..цбааббааббаа...юююаа...аю4..4юа..EDFWWWWWWWWWWWW
WWWWWWWFDE..ббааббааббаа...IIIII...аю....юю..EDFWWWWWWWWWWWW
WWWWWWWF.E..WWWWWWWWWWWW...........цбб..ббц..EDFWWFFFFFWWWWW
WWWWWWWF.E..WWWWWWWWWWWW...2.2.2.............E.FWWFEEEFWWWWW
WWWWWWWF.E..IIIWWWWWWWWW.....................EDFWWFEFEFWWWWW
WWWWWWWF.E..бббWWWббббаа...........FFFFFFFF..EDFWWFEEEFWWWWW
WWWWWWWFDE..бббWWWббббаа.....9..........FFF..E.FWWFFFFFWWWWW
WWWWWWWFDE........бб....................FFF..E.FWWWWWWWWWWWW
WWWWWWWF.E..FFF.................ббWWWI.......E.FWWWWWWWWWWWW
WWWWWWWFDE..FFFF..........бцбббцббWWWI.......E.FWWWWWWWWWWWW
WWWWWWWFDE.........IIIWWWWббааааббWWWWWWWI...E.FFFFFFFWWWWWW
WWWWWWWF.EEEEEEE...IWWWWWWWWWWWWWWWWWWWWWI...E.......FWWWWWW
WWWWWWWF.......E...IWWWWWWWWWWWWWWWWWWWWWI...EEEEEEE.FWWWWWW
WWWWWWWFFFFFFF.E...IWWWWWWWббааааббWWWWIII.........E.FWWWWWW
WWWWWWWWWWWWWF.E.......IWWWббцбббцб..........FFFF..E.FWWWWWW
WWWWWWWWWWWWWF.E.......IWWWбб.................FFF..EDFWWWWWW
WWWWWWWWWWWWWFDE..FFF....................бб........EDFWWWWWW
WWWWWWWWWWWWWF.E..FFF..........8.....ааббббWWWббб..EDFWWWWWW
WWWWWWFFFFFWWFDE..FFFFFFFF...........ааббббWWWббб..EDFWWWWWW
WWWWWWFEEEFWWFDE.....................WWWWWWWWWIII..EDFWWWWWW
WWWWWWFEFEFWWF.E.............1.1.1...WWWWWWWWWWWW..E.FWWWWWW
WWWWWWFEEEFWWF.E..цбб..ббц...........WWWWWWWWWWWW..E.FWWWWWW
WWWWWWFFFFFWWF.E..аю....юа...IIIII...ааббааббаабб..E.FWWWWWW
WWWWWWWWWWWWWF.E..аю4..4юа...ааююю...ааббааббаабц..E.FWWWWWW
WWWWWWWWWWWWWF.E..аббаабба...ааббб.................E.FWWWWWW
WWWWWWWWWWWWWF.E..цббааббц...ююббб.................E.FWWWWWW
WWWWWWWWWWWWWF.E.............WWWWW...EEEEEEEEEEEEEEE.FWWWWWW
WWWWWWWWWWWWWF.E.............WWWWW...E..D..DDDDDDD...FWWWWWW
WWWWWWWWWWWWWF.EEEEEEEEEEEEEEEEEEEEEEE.FFFFFFFFFFFFFFFWWWWWW
WWWWWWWWWWWWWF..DD.....D.....D.D.......FWWWWWWWWWWWWWWWWWWWW
WWWWWWWWWWWWWFFFFFFFFFFFFFFFFFFFFFFFFFFFWWWWWWWWWWWWWWWWWWWW
WWWWWWWWWWWWWWWWWWWWWWWWWWWWWWWWWWWWWWWWWWFFFFFWWWWWWWWWWWWW
WWWWWWWWWWWWWWWWWWWWWWWWWWWWWWWWWWWWWWWWWWFEEEFWWWWWWWWWWWWW
WWWWWWWWWWWWWWWWWWWWWWWWWWWWWWWWWWWWWWWWWWFEFEFWWWWWWWWWWWWW
WWWWWWWWWWWWWWWWWWWWWWWWWWWWWWWWWWWWWWWWWWFEEEFWWWWWWWWWWWWW
WWWWWWWWWWWWWWWWWWWWWWWWWWWWWWWWWWWWWWWWWWFFFFFWWWWWWWWWWWWW
WWWWWWWWWWWWWWWWWWWWWWWWWWWWWWWWWWWWWWWWWWWWWWWWWWWWWWWWWWWW
WWWWWWWWWWWWWWWWWWWWWWWWWWWWWWWWWWWWWWWWWWWWWWWWWWWWWWWWWWWW
WWWWWWWWWWWWWWWWWWWWWWWWWWWWWWWWWWWWWWWWWWWWWWWWWWWWWWWWWWWW
WWWWWWWWWWWWWWWWWWWWWWWWWWWWWWWWWWWWWWWWWWWWWWWWWWWWWWWWWWWW
WWWWWWWWWWWWWWWWWWWWWWWWWWWWWWWWWWWWWWWWWWWWWWWWWWWWWWWWWWWW
WWWWWWWWWWWWWWWWWWWWWWWWWWWWWWWWWWWWWWWWWWWWWWWWWWWWWWWWWWWW