WWWWWWWWWWWWWWWWWWWWWWWWWWWWWWWWWWWWWWWWWWWWWWWWWWWWWWWWWWWW
WWWWWWWWWWWWWWWWWWWWWWWWWWWWWWWWWWWWWWWWWWWWWWWWWWWWWWWWWWWW
WWWWWWWWWWWWWWWWWWWWWWWWWWWWWWWWWWWWWWWWWWWWWWWWWWWWWWWWWWWW
WWWWWWWWWWWWWWWWWWWWWWWWWWWWWWWWWWWWWWWWWWWWWWWWWWWWWWWWWWWW
WWWWWWWWWWWWWWWWWWWWWWWWWWWWWWWWWWWWWWWWWWWWWWWWWWWWWWWWWWWW
WWWWWWWWWWWWWWWWWWWWWWWWWWWWWWWWWWWWWWWWWWWWWWWWWWWWWWWWWWWW
WWWWWWWWWWWWWWWWWWWWWWWWWWWWWWWWWWWWWWWWWWWWWWWWWWWWWWWWWWWW
WWWWWWWWWWWWWWWWWWWWWWWWWWWWWWWWWWWWWWWWWWWWWWWWWWWWWWWWWWWW
WWWWWWWWWWWWWWWWWWWWWWWWWWWWWWWWWWWWWWWWWWWWWWWWWWWWWWWWWWWW
WWWWWWWWWWWWWWWWWWWWWWWWWWWWWWWWWWWWWWWWWWWWWWWWWWWWWWWWWWWW
WWWWWWWWWWWWWWWWWWWWWWWWWWWWWWWWWWWWWWWWWWWWWWWWWWWWWWWWWWWW
WWWWWWWWWWWWWWWWWWEEEEEEEEEEWWWWEEEEEEEEEEWWWWWWWWWWWWWWWWWW
WWWWWWWWWWWWWWWWWWE...TT...EWWWWE...CC...EWWWWWWWWWWWWWWWWWW
WWWWWWWWWWWWWWWWWWE........EWWWWE........EWWWWWWWWWWWWWWWWWW
WWWWWWWWWWWWWWWEEEE........EEEEEE........EEEEWWWWWWWWWWWWWWW
WWWWWWWWWWWWWWWEBB...........MM...........BBEWWWWWWWWWWWWWWW
WWWWWWWWWWWWWWWEBB...........XX...........BBEWWWWWWWWWWWWWWW
WWWWWWWWWEEEEEEE.....N................N.....EEEEEEEWWWWWWWWW
WWWWWWWWWE...........NWWWW........WWWWN...........EWWWWWWWWW
WWWWWWWWWE...........NWWWW........WWWWN...........EWWWWWWWWW
WWWWWWWWWE..4.4.4..........................1.1.1..EWWWWWWWWW
WWWWWWWWWE..................FFFF..................EWWWWWWWWW
WWWWWWWWWE.........WWWW.....NNN......WWWW.........EWWWWWWWWW
WWWWWWWWWE..CC.....WWWW......BB......WWWW.....CC..EWWWWWWWWW
WWWWWWWWWE..CC.....FFF................FFF.....CC..EWWWWWWWWW
WWWWWWWWWE........FFF.....I......I.....FFF........EWWWWWWWWW
WWWWWWWWWE......YWWWW....YI..D...IC....WWWW.......EWWWWWWWWW
WWWWWWWWWEX......WWWW..................WWWWC.....XEWWWWWWWWW
WWWWWWWWWEX........NN.......g..g.......NN........XEWWWWWWWWW
WWWWWWWWWEMXX......BB....D.............BB......XXMEWWWWWWWWW
WWWWWWWWWEMXX......BB.............D....BB......XXMEWWWWWWWWW
WWWWWWWWWEX........NN.......g..g.......NN........XEWWWWWWWWW
WWWWWWWWWEX.....CWWWW..................WWWW......XEWWWWWWWWW
WWWWWWWWWE.......WWWW....CI...D..IY....WWWWY......EWWWWWWWWW
WWWWWWWWWE........FFF.....I......I.....FFF........EWWWWWWWWW
WWWWWWWWWE..CC.....FFF................FFF.....CC..EWWWWWWWWW
WWWWWWWWWE..CC.....WWWW......BB......WWWW.....CC..EWWWWWWWWW
WWWWWWWWWE.........WWWW.....NNNN.....WWWW.........EWWWWWWWWW
WWWWWWWWWE..................FFFF..................EWWWWWWWWW
WWWWWWWWWE..2.2.2..........................3.3.3..EWWWWWWWWW
WWWWWWWWWE...........NWWWW........WWWWN...........EWWWWWWWWW
WWWWWWWWWE...........NWWWW........WWWWN...........EWWWWWWWWW
WWWWWWWWWEEEEEEE.....N................N.....EEEEEEEWWWWWWWWW
WWWWWWWWWWWWWWWEBB...........XX...........BBEWWWWWWWWWWWWWWW
WWWWWWWWWWWWWWWEBB...........MM...........BBEWWWWWWWWWWWWWWW
WWWWWWWWWWWWWWWEEEE........EEEEEE........EEEEWWWWWWWWWWWWWWW
WWWWWWWWWWWWWWWWWWE........EWWWWE........EWWWWWWWWWWWWWWWWWW
WWWWWWWWWWWWWWWWWWE...CC...EWWWWE...TT...EWWWWWWWWWWWWWWWWWW
WWWWWWWWWWWWWWWWWWEEEEEEEEEEWWWWEEEEEEEEEEWWWWWWWWWWWWWWWWWW
WWWWWWWWWWWWWWWWWWWWWWWWWWWWWWWWWWWWWWWWWWWWWWWWWWWWWWWWWWWW
WWWWWWWWWWWWWWWWWWWWWWWWWWWWWWWWWWWWWWWWWWWWWWWWWWWWWWWWWWWW
WWWWWWWWWWWWWWWWWWWWWWWWWWWWWWWWWWWWWWWWWWWWWWWWWWWWWWWWWWWW
WWWWWWWWWWWWWWWWWWWWWWWWWWWWWWWWWWWWWWWWWWWWWWWWWWWWWWWWWWWW
WWWWWWWWWWWWWWWWWWWWWWWWWWWWWWWWWWWWWWWWWWWWWWWWWWWWWWWWWWWW
WWWWWWWWWWWWWWWWWWWWWWWWWWWWWWWWWWWWWWWWWWWWWWWWWWWWWWWWWWWW
WWWWWWWWWWWWWWWWWWWWWWWWWWWWWWWWWWWWWWWWWWWWWWWWWWWWWWWWWWWW
WWWWWWWWWWWWWWWWWWWWWWWWWWWWWWWWWWWWWWWWWWWWWWWWWWWWWWWWWWWW
WWWWWWWWWWWWWWWWWWWWWWWWWWWWWWWWWWWWWWWWWWWWWWWWWWWWWWWWWWWW
WWWWWWWWWWWWWWWWWWWWWWWWWWWWWWWWWWWWWWWWWWWWWWWWWWWWWWWWWWWW
WWWWWWWWWWWWWWWWWWWWWWWWWWWWWWWWWWWWWWWWWWWWWWWWWWWWWWWWWWWW