WWWWWWWWWWWWWWWWWWWWWWWWWWWWWWWWWWWWWWWWWWWWWWWWWWWWWWWWWWWW
WWWWWWWWWWWWWWWWWWWWWWWWWWWWWWWWWWWWWWWWWWWWWWWWWWWWWWWWWWWW
WWWWWWWWWWWWWWWWWWWWWWWWWWWWWWWWWWWWWWWWWWWWWWWWWWWWWWWWWWWW
WWWWWWWWWWWWWWWWWWWWWWWWWWWWWWWWWWWWWWWWWWWWWWWWWWWWWWWWWWWW
WWWWWWWWWWWWWWWWWWWWWWWWWWWWWWWWWWWWWWWWWWWWWWWWWWWWWWWWWWWW
WWWWWWWWWWWWWWWWWWWWWWWWWWWWWWWWWWWWWWWWWWWWWWWWWWWWWWWWWWWW
WWWWWWWWWWWWWWWWWWWWWWWWWWWWWWWWWWWWWWWWWWWWWWWWWWWWWWWWWWWW
WWWWWWWWWWWWWWWWWWWWWWWWWWWWWWWWWWWWWWWWWWWWWWWWWWWWWWWWWWWW
WWWWWWWWWWWWWWWWWWWWWWWWWWWWWWWWWWWWWWWWWWWWWWWWWWWWWWWWWWWW
WWWWWWWWWEEEEEEEEEEEEEEEWWWWWWWWWWWWEEEEEEEEEEEEEEEWWWWWWWWW
WWWWWWWWWE..........FFMEWWWWWWWWWWWWEMFF..........EWWWWWWWWW
WWWWWWWWWE..4.4.4...FFMEWWWWWWWWWWWWEMFF...1.1.1..EWWWWWWWWW
WWWWWWWWWE.............EEEWWWWWWWWEEE.............EWWWWWWWWW
WWWWWWWWWE...............EWWWWWWWWE...............EWWWWWWWWW
WWWWWWWWWE....P.MM.......EEEWWWWEEE.......MMO.....EWWWWWWWWW
WWWWWWWWWE......MM.......FFEWWWWEFF.......MM......EWWWWWWWWW
WWWWWWWWWE....MMMM.......FFEEEEEEFF.......MMMM....EWWWWWWWWW
WWWWWWWWWE....MMMM........................MMMM....EWWWWWWWWW
WWWWWWWWWE........................................EWWWWWWWWW
WWWWWWWWWE...........T...bbbbbbbbbb...T...........EWWWWWWWWW
WWWWWWWWWEFF.........I...b........b...I.........FFEWWWWWWWWW
WWWWWWWWWEFF.......TII...b...FF...b...IIT.......FFEWWWWWWWWW
WWWWWWWWWEMMM............b...FF...b............MMMEWWWWWWWWW
WWWWWWWWWEMMM............b........b............MMMEWWWWWWWWW
WWWWWWWWWEM..............b...YY...b..............MEWWWWWWWWW
WWWWWWWWWE.........bbbbbbb........bbbbbbb.........EWWWWWWWWW
WWWWWWWWWE.........b....................b.........EWWWWWWWWW
WWWWWWWWWEF...N....b.......g....g.......b....N...FEWWWWWWWWW
WWWWWWWWWEFF..N....b.........WW.........b....N..FFEWWWWWWWWW
WWWWWWWWWEFF..NY...b.FF.Y...WWWW...Y.FF.b...YN..FFEWWWWWWWWW
WWWWWWWWWEFF..NY...b.FF.Y...WWWW...Y.FF.b...YN..FFEWWWWWWWWW
WWWWWWWWWEFF..N....b.........WW.........b....N..FFEWWWWWWWWW
WWWWWWWWWEF...N....b.......g....g.......b....N...FEWWWWWWWWW
WWWWWWWWWE.........b....................b.........EWWWWWWWWW
WWWWWWWWWE.........bbbbbbb........bbbbbbb.........EWWWWWWWWW
WWWWWWWWWEM..............b...YY...b..............MEWWWWWWWWW
WWWWWWWWWEMMM............b........b............MMMEWWWWWWWWW
WWWWWWWWWEMMM............b...FF...b............MMMEWWWWWWWWW
WWWWWWWWWEFF.......TII...b...FF...b...IIT.......FFEWWWWWWWWW
WWWWWWWWWEFF.........I...b........b...I.........FFEWWWWWWWWW
WWWWWWWWWE...........T...bbbbbbbbbb...T...........EWWWWWWWWW
WWWWWWWWWE........................................EWWWWWWWWW
WWWWWWWWWE....MMMM........................MMMM....EWWWWWWWWW
WWWWWWWWWE....MMMM.......FFEEEEEEFF.......MMMM....EWWWWWWWWW
WWWWWWWWWE....U.MM.......FFEWWWWEFF.......MMZ.....EWWWWWWWWW
WWWWWWWWWE......MM.......EEEWWWWEEE.......MM......EWWWWWWWWW
WWWWWWWWWE...............EWWWWWWWWE...............EWWWWWWWWW
WWWWWWWWWE.............EEEWWWWWWWWEEE.............EWWWWWWWWW
WWWWWWWWWE..2.2.2...FFMEWWWWWWWWWWWWEMFF...3.3.3..EWWWWWWWWW
WWWWWWWWWE..........FFMEWWWWWWWWWWWWEMFF..........EWWWWWWWWW
WWWWWWWWWEEEEEEEEEEEEEEEWWWWWWWWWWWWEEEEEEEEEEEEEEEWWWWWWWWW
WWWWWWWWWWWWWWWWWWWWWWWWWWWWWWWWWWWWWWWWWWWWWWWWWWWWWWWWWWWW
WWWWWWWWWWWWWWWWWWWWWWWWWWWWWWWWWWWWWWWWWWWWWWWWWWWWWWWWWWWW
WWWWWWWWWWWWWWWWWWWWWWWWWWWWWWWWWWWWWWWWWWWWWWWWWWWWWWWWWWWW
WWWWWWWWWWWWWWWWWWWWWWWWWWWWWWWWWWWWWWWWWWWWWWWWWWWWWWWWWWWW
WWWWWWWWWWWWWWWWWWWWWWWWWWWWWWWWWWWWWWWWWWWWWWWWWWWWWWWWWWWW
WWWWWWWWWWWWWWWWWWWWWWWWWWWWWWWWWWWWWWWWWWWWWWWWWWWWWWWWWWWW
WWWWWWWWWWWWWWWWWWWWWWWWWWWWWWWWWWWWWWWWWWWWWWWWWWWWWWWWWWWW
WWWWWWWWWWWWWWWWWWWWWWWWWWWWWWWWWWWWWWWWWWWWWWWWWWWWWWWWWWWW
WWWWWWWWWWWWWWWWWWWWWWWWWWWWWWWWWWWWWWWWWWWWWWWWWWWWWWWWWWWW