.........WWWC.......Y
.........WWWF........
..2...2...WWF........
..........FFF....NNNN
.....................
................b....
.........WW.....b....
.........WWW....b....
F.......NWWWTT..b.CYY
FF......NWWWWW..b....
FFF.....NWWWWW..b....
MFF...NNNWWWWW..b..FF
MMM......WWWFF..b..FF
................b..FF
................b....
................b....
....bbbbbbbbbbbbb....
....b................
....b................
FF..b................
FF..b..FFWWW......MMM
FF..b..WWWWWNNN...FFM
....b..WWWWWN.....FFF
....b..WWWWWN......FF
YYC.b..TTWWWN.......F
....b....WWW.........
....b.....WW.........
....b................
.....................
NNNN....FFF..........
........FWW...1...1..
........FWWW.........
Y.......CWWW.........