........2...2........
.....................
.....................
.....Y...............
...NNNNN........CC...
...C............MMM..
.....................
.....bbbbbbbbb.......
.....b...............
..FF.b.FF...FF.......
YYFF.b.FFYYYFF.....MM
..FF.b.FF...FF...TMMM
.....b...............
.....bbbbbb..........
..........b..........
..FF...FF.b.FF...FF..
..FFYYYFF.b.FFYYYFF..
..FF...FF.b.FF...FF..
..........b..........
..........bbbbbb.....
...............b.....
MMMT...FF...FF.b.FF..
MM.....FFYYYFF.b.FFYY
.......FF...FF.b.FF..
...............b.....
.......bbbbbbbbb.....
.....................
..MMM............C...
...CC........NNNNN...
...............Y.....
.....................
.....................
........1...1........