110000004040400002221
110000000000000000221
000000002200000000001
000000022200000000000
220000111100000000000
110000000000000000000
000000000000000000000
000000000000000000000
000000000002222220000
000222000022222222000
000222000222222222200
00011W002222211122220
000000002222000002222
000000002550000002222
222220000000000002222
222222000000000112222
222222000090000222222
222211000000000222222
222200000000000022222
222200000055200000000
222200000222200000000
022221112222200W11000
002222222222000222000
000222222220000222000
000022222200000000000
000000000000000000000
000000000000000000000
000000000000000000011
000000000001111000022
000000000002220000000
100000000002200000000
122000000000000000011
122200004040400000011