002200004040400000000
002200000000000002200
000000000000000002200
000000000000000000000
000000000000002200000
000220000000002200000
000510000000001100000
222555500000001111222
222222200000002222222
222000000000000000222
220000000000000000022
220005555000111100022
220005222000222100022
220005200000002100022
220005200000002100022
220002200000002200022
220002200090002200022
220002200000002200022
220001200000002500022
220001200000002500022
220001222000222500022
220001111000555500022
220000000000000000022
222000000000000000222
222222200000002222222
222111100000005555222
000001100000000015000
000002200000000022000
000002200000000000000
000000000000000000000
002200000000000000000
002200000000000002200
000000004040400002200
