110000004040400000011
110000000000000000011
110000000000000000000
000000000000000000000
000000000000000000000
000000111000000110222
221100000001100000222
221100000000000000222
222200000000000001122
222222551221112221122
222222222222222221122
221100000000000000022
220002210000000211002
200002550000000221000
200000000000000000000
000000000090000000000
000000000000000000001
000122000000055200002
200112000000052200022
220000000000000001122
221122222222222222222
221122211122155222222
221100000000000002222
222000000000000002222
222000001100000001122
222011000000111000000
000000000000000000000
000000000000000000000
0000000000G0000000000
000000000000000000000
110000000000000000011
110000004040400000011