WWWWWWWWWWWWWWWWWWWWWWWWWWWWWWWWWWWWWWWWWWWWWWWWWWWWWWWWWWWW
WWWWWWWWWWWWWWWWWWWWWWWWWWWWWWWWWWWWWWWWWWWWWWWWWWWWWWWWWWWW
WWWWWWWWWWWWWWWWWWWWWWWWWWWWWWWWWWWWWWWWWWWWWWWWWWWWWWWWWWWW
WWWWWWWWWWWWWWWWWWWWWWWWWWWWWWWWWWWWWWWWWWWWWWWWWWWWWWWWWWWW
WWWWWWWWWWWWWWWWWWWWWWWWWWWWWWWWWWWWWWWWWWWWWWWWWWWWWWWWWWWW
WWWWWWWWWWWWWWWWWWWWWWWWWWWWWWWWWWWWWWWWWWWWWWWWWWWWWWWWWWWW
WWWWWWWWWWWWWWWWWWWWWWWWWWWWWWWWWWWWWWWWWWWWWWWWWWWWWWWWWWWW
WWWWWWWWWWWWWWWWWWWWWWWWWWWWWWWWWWWWWWWWWWWWWWWWWWWWWWWWWWWW
WWWWWWWWWWWWWWWWWWWWWWWWWWWWWWWWWWWWWWWWWWWWWWWWWWWWWWWWWWWW
WWWWWWWWWWWWWWWWWWWWWWWWWWWWWWWWWWWWWWWWWWWWWWWWWWWWWWWWWWWW
WWWWWWWWWWWWWWEEEEEEEEEEEEEEEEEEEEEEEEEEEEEEEEWWWWWWWWWWWWWW
WWWWWWWWWWWWWWEXXMMMMY...XFFFFFFFFFX...YMMMXXEWWWWWWWWWWWWWW
WWWWWWWWWWWWWWEXCYT......................YY..EWWWWWWWWWWWWWW
WWWWWWWWWWWEEEE..........................T...EEEEWWWWWWWWWWW
WWWWWWWWWWWECY............2.2.2.2.2.............EWWWWWWWWWWW
WWWWWWWWWWWEY...................................EWWWWWWWWWWW
WWWWWWWWWWWE....................................EWWWWWWWWWWW
WWWWWWWWWWWE....................................EWWWWWWWWWWW
WWWWWWWWWWWE....................................EWWWWWWWWWWW
WWWWWWWWWWWE.......MM......NNNT..............L..EWWWWWWWWWWW
WWWWWWWWWWWEXL.....MM......YWWW......YFFFF......EWWWWWWWWWWW
WWWWWWWWWWWEX......MFFF.....WWW......MMMFF...MMMEWWWWWWWWWWW
WWWWWWWWWWWENNNN...MFFFM....WWWW..FFMM..........EWWWWWWWWWWW
WWWWWWWWWWWE...N....FFFM....WWWW..FFMC..........EWWWWWWWWWWW
WWWWWWWWWWWE...........MM..FWWWW....M...........EWWWWWWWWWWW
WWWWWWWWWWWE...........MM..FWWW.....M...........EWWWWWWWWWWW
WWWWWWWWWWWE...............FFWWc..........FFM...EWWWWWWWWWWW
WWWWWWWWWWWE...X...........FFWW..........MFFM...EWWWWWWWWWWW
WWWWWWWWWWWE...MFF.........FFWWNNN.......MFFMWWWEWWWWWWWWWWW
WWWWWWWWWWWEWWWMFFMX.......FWWWWF......TXMFFMWWWEWWWWWWWWWWW
WWWWWWWWWWWEWWWMFFMXT......FWWWWF.......XMFFMWWWEWWWWWWWWWWW
WWWWWWWWWWWEWWWMFFM.......NNNWWFF.........FFM...EWWWWWWWWWWW
WWWWWWWWWWWE...MFFM........c.WWFF...........X...EWWWWWWWWWWW
WWWWWWWWWWWE...MFF...........WWFF...............EWWWWWWWWWWW
WWWWWWWWWWWE...........M.....WWWF..MM...........EWWWWWWWWWWW
WWWWWWWWWWWE...........M....WWWWF..MM...........EWWWWWWWWWWW
WWWWWWWWWWWE..........CMFF..WWWW....MFFF....N...EWWWWWWWWWWW
WWWWWWWWWWWE..........MMFF..WWWW....MFFFM...NNNNEWWWWWWWWWWW
WWWWWWWWWWWEMMM...FFMMM......WWW.....FFFM....K.XEWWWWWWWWWWW
WWWWWWWWWWWE.K....FFFFY......WWWY......MM......XEWWWWWWWWWWW
WWWWWWWWWWWE.................TNNN......MM.......EWWWWWWWWWWW
WWWWWWWWWWWE....................................EWWWWWWWWWWW
WWWWWWWWWWWE....................................EWWWWWWWWWWW
WWWWWWWWWWWE....................................EWWWWWWWWWWW
WWWWWWWWWWWE...................................YEWWWWWWWWWWW
WWWWWWWWWWWE.............1.1.1.1.1............YCEWWWWWWWWWWW
WWWWWWWWWWWEEEE...T..........................EEEEWWWWWWWWWWW
WWWWWWWWWWWWWWE..YY......................TYCXEWWWWWWWWWWWWWW
WWWWWWWWWWWWWWEXXMMMY...XFFFFFFFFFX...YMMMMXXEWWWWWWWWWWWWWW
WWWWWWWWWWWWWWEEEEEEEEEEEEEEEEEEEEEEEEEEEEEEEEWWWWWWWWWWWWWW
WWWWWWWWWWWWWWWWWWWWWWWWWWWWWWWWWWWWWWWWWWWWWWWWWWWWWWWWWWWW
WWWWWWWWWWWWWWWWWWWWWWWWWWWWWWWWWWWWWWWWWWWWWWWWWWWWWWWWWWWW
WWWWWWWWWWWWWWWWWWWWWWWWWWWWWWWWWWWWWWWWWWWWWWWWWWWWWWWWWWWW
WWWWWWWWWWWWWWWWWWWWWWWWWWWWWWWWWWWWWWWWWWWWWWWWWWWWWWWWWWWW
WWWWWWWWWWWWWWWWWWWWWWWWWWWWWWWWWWWWWWWWWWWWWWWWWWWWWWWWWWWW
WWWWWWWWWWWWWWWWWWWWWWWWWWWWWWWWWWWWWWWWWWWWWWWWWWWWWWWWWWWW
WWWWWWWWWWWWWWWWWWWWWWWWWWWWWWWWWWWWWWWWWWWWWWWWWWWWWWWWWWWW
WWWWWWWWWWWWWWWWWWWWWWWWWWWWWWWWWWWWWWWWWWWWWWWWWWWWWWWWWWWW
WWWWWWWWWWWWWWWWWWWWWWWWWWWWWWWWWWWWWWWWWWWWWWWWWWWWWWWWWWWW
WWWWWWWWWWWWWWWWWWWWWWWWWWWWWWWWWWWWWWWWWWWWWWWWWWWWWWWWWWWW