WWWWWWWWWWWWWWWWWWWWWWWWWWWWWWWWWWWWWWWWWWWWWWWWWWWWWWWWWWWW
WWWWWWWWWWWWWWWWWWWWWWWWWWWWWWWWWWWWWWWWWWWWWWWWWWWWWWWWWWWW
WWWWWWWWWWWWWWWWWWWWWWWWWWWWWWWWWWWWWWWWWWWWWWWWWWWWWWWWWWWW
WWWWWWWWWWWWWWWWWWWWWWWWWWWWWWWWWWWWWWWWWWWWWWWWWWWWWWWWWWWW
WWWWWWWWWWWWWWWWWWWWWWWWWWWWWWWWWWWWWWWWWWWWWWWWWWWWWWWWWWWW
WWWWWWWWWWWWWWWWWWWWWWWWWWWWWWWWWWWWWWWWWWWWWWWWWWWWWWWWWWWW
WWWWWWWWWWWWWWWWWWWWWWWWWWWWWWWWWWWWWWWWWWWWWWWWWWWWWWWWWWWW
WWWWWWWWWWWWWWWWWWWWWWWWWWWWWWWWWWWWWWWWWWWWWWWWWWWWWWWWWWWW
WWWWWWWWWWWWWWWWWWWWWWWWWWWWWWWWWWWWWWWWWWWWWWWWWWWWWWWWWWWW
WWWWWWWWWWWWWWWWWWWWWWWWWWWWWWWWWWWWWWWWWWWWWWWWWWWWWWWWWWWW
WWWWWWWWWWWWWWWWWWWWWWWWWWWWWWWWWWWWWWWWWWWWWWWWWWWWWWWWWWWW
WWWWWWWWWWWWWWWWWWWWWEEEEEEEEEEEEEEEEEEWWWWWWWWWWWWWWWWWWWWW
WWWWWWWWWWWWWWWWWWWWWEBB............BBEWWWWWWWWWWWWWWWWWWWWW
WWWWWWWWWWWWWWWWWWWWWE....2.2.2.2.2...EWWWWWWWWWWWWWWWWWWWWW
WWWWWWWWWWWWWWWWWWEEEE................EEEEWWWWWWWWWWWWWWWWWW
WWWWWWWWWWWWWWWWWWEC...................YTEWWWWWWWWWWWWWWWWWW
WWWWWWWWWWWWWWWWWWEC.........FF........CYEWWWWWWWWWWWWWWWWWW
WWWWWWWWWWWWWWWEEEE..........FF..........EEEEWWWWWWWWWWWWWWW
WWWWWWWWWWWWWWWE...........XXFFXX...........EWWWWWWWWWWWWWWW
WWWWWWWWWWWWWWWE...........TC..YC...........EWWWWWWWWWWWWWWW
WWWWWWWWWWWWEEEE............................EEEEWWWWWWWWWWWW
WWWWWWWWWWWWEXMMMMFFFFFYC.............M......YCEWWWWWWWWWWWW
WWWWWWWWWWWWEXXB..FFFFF...............MM.......EWWWWWWWWWWWW
WWWWWWWWWEEEEY...............FF.......TXF......EEEEWWWWWWWWW
WWWWWWWWWE..YY..............FFFF.WW.....FF........EWWWWWWWWW
WWWWWWWWWE...........Y......FFFFWWW.....FFXX......EWWWWWWWWW
WWWWWWWWWE.......M...MMMM..FFFIWWWW.....FFTMM.....EWWWWWWWWW
WWWWWWWWWEB......M.....BX..FFFIWWWNNN...FFFF.....BEWWWWWWWWW
WWWWWWWWWEB....MMM.........FFFF..................BEWWWWWWWWW
WWWWWWWWWET.................FFFF.................TEWWWWWWWWW
WWWWWWWWWET.................FFFF.................TEWWWWWWWWW
WWWWWWWWWEB..................FFFF.........MMM....BEWWWWWWWWW
WWWWWWWWWEB.....FFFF...NNNWWWIFFF..XB.....M......BEWWWWWWWWW
WWWWWWWWWE.....MMTFF.....WWWWIFFF..MMMM...M.......EWWWWWWWWW
WWWWWWWWWE......XXFF.....WWWFFFF......Y...........EWWWWWWWWW
WWWWWWWWWE........FF.....WW.FFFF..............YY..EWWWWWWWWW
WWWWWWWWWEEEE......FXT.......FF...............YEEEEWWWWWWWWW
WWWWWWWWWWWWE.......MM...............FFFFF..BXXEWWWWWWWWWWWW
WWWWWWWWWWWWECY......M.............CYFFFFFMMMMXEWWWWWWWWWWWW
WWWWWWWWWWWWEEEE............................EEEEWWWWWWWWWWWW
WWWWWWWWWWWWWWWE...........CY..CT...........EWWWWWWWWWWWWWWW
WWWWWWWWWWWWWWWE...........XXFFXX...........EWWWWWWWWWWWWWWW
WWWWWWWWWWWWWWWEEEE..........FF..........EEEEWWWWWWWWWWWWWWW
WWWWWWWWWWWWWWWWWWEYC........FF.........CEWWWWWWWWWWWWWWWWWW
WWWWWWWWWWWWWWWWWWETY...................CEWWWWWWWWWWWWWWWWWW
WWWWWWWWWWWWWWWWWWEEEE................EEEEWWWWWWWWWWWWWWWWWW
WWWWWWWWWWWWWWWWWWWWWE...1.1.1.1.1....EWWWWWWWWWWWWWWWWWWWWW
WWWWWWWWWWWWWWWWWWWWWEBB............BBEWWWWWWWWWWWWWWWWWWWWW
WWWWWWWWWWWWWWWWWWWWWEEEEEEEEEEEEEEEEEEWWWWWWWWWWWWWWWWWWWWW
WWWWWWWWWWWWWWWWWWWWWWWWWWWWWWWWWWWWWWWWWWWWWWWWWWWWWWWWWWWW
WWWWWWWWWWWWWWWWWWWWWWWWWWWWWWWWWWWWWWWWWWWWWWWWWWWWWWWWWWWW
WWWWWWWWWWWWWWWWWWWWWWWWWWWWWWWWWWWWWWWWWWWWWWWWWWWWWWWWWWWW
WWWWWWWWWWWWWWWWWWWWWWWWWWWWWWWWWWWWWWWWWWWWWWWWWWWWWWWWWWWW
WWWWWWWWWWWWWWWWWWWWWWWWWWWWWWWWWWWWWWWWWWWWWWWWWWWWWWWWWWWW
WWWWWWWWWWWWWWWWWWWWWWWWWWWWWWWWWWWWWWWWWWWWWWWWWWWWWWWWWWWW
WWWWWWWWWWWWWWWWWWWWWWWWWWWWWWWWWWWWWWWWWWWWWWWWWWWWWWWWWWWW
WWWWWWWWWWWWWWWWWWWWWWWWWWWWWWWWWWWWWWWWWWWWWWWWWWWWWWWWWWWW
WWWWWWWWWWWWWWWWWWWWWWWWWWWWWWWWWWWWWWWWWWWWWWWWWWWWWWWWWWWW
WWWWWWWWWWWWWWWWWWWWWWWWWWWWWWWWWWWWWWWWWWWWWWWWWWWWWWWWWWWW
WWWWWWWWWWWWWWWWWWWWWWWWWWWWWWWWWWWWWWWWWWWWWWWWWWWWWWWWWWWW