WWWWWWWWWWWWWWWWWWWWWWWWWWWWWWWWWWWWWWWWWWWWWWWWWWWWWWWWWWWW
WWWWWWWWWWWWWWWWWWWWWWWWWWWWWWWWWWWWWWWWWWWWWWWWWWWWWWWWWWWW
WWWWWWWWWWWWWWWWWWWWWWWWWWWWWWWWWWWWWWWWWWWWWWWWWWWWWWWWWWWW
WWWWWWWWWWWWWWWWWWWWWWWWWWWWWWWWWWWWWWWWWWWWWWWWWWWWWWWWWWWW
WWWWWWWWWWWWWWWWWWWWWWWWWWWWWWWWWWWWWWWWWWWWWWWWWWWWWWWWWWWW
WWWWWWWWWWWWWWWWWWWWWWWWWWWWWWWWWWWWWWWWWWCWWWWWWWWWWWWWWWWW
WWWWWWWWWWWWWWWWWWWWWWWWWWWWWWWWWWWWWWWWWWCWWWWWWWWWWWWWWWWW
WWWWWWWWWWWWWWWWWWWWWWWWWWWWWWWWWWWWWWWWWWCWWWWWWWWWWWWWWWWW
WWWWWWWWWWWWWWWWWWWWWWWWWWWWWWWWWWWWWWWCCCCCCCWWWWWWWWWWWWWW
WWWWWWWWWWWWWWWWWWWWWWWWWWWWWWWWWWWWWWWWWWCWWWWWWWWWWWWWWWWW
WWWWWWWWWWWWWWWWWWWWWWWWWWWWWWWWWWWWWWWWWWCWWWWWWWWWWWWWWWWW
WWWWWWWWWWWWWWWWWWWWWWWWWWWWWWWWWWWWWWWWWWCWWWWWWWWWWWWWWWWW
WWWWWWWWWWWWWWWWWWWWWWWWWWWWWWWWWWWWWWWWWWWWWWWWWWWWWWWWWWWW
WWWWWWWWWWWWWWWEEEEEEEEEEEEEEEEEEEEEWWWWWWWWWWWWWWWWWWWWWWWW
WWWWWWWWWWWWWWWEFFF..FFFFFFFFF..FFFEWWWWWWWWWWWWWWCWWWWWWWWW
WWWWWWWWWWWWWWWEFFF.............FFFEWWWWWWWWWWWWWCCCWWWWWWWW
WWWWWWWWWWWWWWWEFFF......2......FFFEWWWWWWWWWWWWWWCWWWWWWWWW
WWWWWWWWWWWWWWWEFF.....2...2.....FFEWWWWWWWWWWWWWWWWWWWWWWWW
WWWWWWWWWWWWWWWEFF...2.......2...FFEWWWWWWWWWWWWWWWWWWWWWWWW
WWWWWWWWWWWWWWWEFF.......M.......FFEWWWWWWWWWWWWWWWWWWWWWWWW
WWWWWWWWWWWEEEEEFF......MMM......FFEEEEEWWWWWWWWWWWWWWWWWWWW
WWWWWWWWWWWEMMMFFF.....XXXXX.....FFFXXXEWWWWWWWWWWWWWWWWWWWW
WWWWWWWWWWWET.......................e.MEWWWWWWWWWWWWWWWWWWWW
WWWWWWWWWWWE..........................MEWWWWWWWWWWWWWWWWWWWW
WWWWWWWWWWWE.FFFF.....................MEWWWWWWWWWWWWWWWCWWWW
WWWWWWWWWWWE.FFFF.....................MEWWWWWWWWWWWWWWWWWWWW
WWWWWWWWWWWE.FF....CY.............MMMMMEEEEEEEEEEWWWWWWWWWWW
WWWWWWWWWWWE.FF.NNNNN................NNNNNNNNNNNEWWWWWWWWWWW
WWWWWWWWWWWE.FF...................FF............EWWWWWWWWWWW
WWWWWWWWWWWE.FFF.c..FFFFFF........FFFFFF.e..FFF.EWWWWWWWWWWW
WWWWWWWWWWWE.FFF....FFFFFF........FFFFFF....FFF.EWWWWWWWWWWW
WWWWWWWWWWWE............FF...................FF.EWWWWWWWWWWW
WWWWWWWWWWWENNNNNNNNNNN................NNNNN.FF.EWWWWWWWWWWW
WWWWWWWWWWWEEEEEEEEEEMMMMM.............YC....FF.EWWWWWWWWWWW
WWWWWWWWWWWWWWWWWWWWEM.....................FFFF.EWWWWWWWWWWW
WWWWCWWWWWWWWWWWWWWWEM.....................FFFF.EWWWWWWWWWWW
WWWWWWWWWWWWWWWWWWWWEMc.........................EWWWWWWWWWWW
WWWWWWWWWWWWWWWWWWWWEM.........................TEWWWWWWWWWWW
WWWWWWWWWWWWWWWWWWWWEXXXFFF.....XXXXX.....FFFMMMEWWWWWWWWWWW
WWWWWWWWWWWWWWWWWWWWEEEEEFF......MMM......FFEEEEEWWWWWWWWWWW
WWWWWWWWWWWWWWWWWWWWWWWWEFF.......M.......FFEWWWWWWWWWWWWWWW
WWWWWWWWWWWWWWWWWWWWWWWWEFF...1.......1...FFEWWWWWWWWWWWWWWW
WWWWWWWWWWWWWWWWWWWWWWWWEFF.....1...1.....FFEWWWWWWWWWWWWWWW
WWWWWWWWWCWWWWWWWWWWWWWWEFFF......1......FFFEWWWWWWWWWWWWWWW
WWWWWWWWCCCWWWWWWWWWWWWWEFFF.............FFFEWWWWWWWWWWWWWWW
WWWWWWWWWCWWWWWWWWWWWWWWEFFF..FFFFFFFFF..FFFEWWWWWWWWWWWWWWW
WWWWWWWWWWWWWWWWWWWWWWWWEEEEEEEEEEEEEEEEEEEEEWWWWWWWWWWWWWWW
WWWWWWWWWWWWWWWWWWWWWWWWWWWWWWWWWWWWWWWWWWWWWWWWWWWWWWWWWWWW
WWWWWWWWWWWWWWWWWCWWWWWWWWWWWWWWWWWWWWWWWWWWWWWWWWWWWWWWWWWW
WWWWWWWWWWWWWWWWWCWWWWWWWWWWWWWWWWWWWWWWWWWWWWWWWWWWWWWWWWWW
WWWWWWWWWWWWWWWWWCWWWWWWWWWWWWWWWWWWWWWWWWWWWWWWWWWWWWWWWWWW
WWWWWWWWWWWWWWCCCCCCCWWWWWWWWWWWWWWWWWWWWWWWWWWWWWWWWWWWWWWW
WWWWWWWWWWWWWWWWWCWWWWWWWWWWWWWWWWWWWWWWWWWWWWWWWWWWWWWWWWWW
WWWWWWWWWWWWWWWWWCWWWWWWWWWWWWWWWWWWWWWWWWWWWWWWWWWWWWWWWWWW
WWWWWWWWWWWWWWWWWCWWWWWWWWWWWWWWWWWWWWWWWWWWWWWWWWWWWWWWWWWW
WWWWWWWWWWWWWWWWWWWWWWWWWWWWWWWWWWWWWWWWWWWWWWWWWWWWWWWWWWWW
WWWWWWWWWWWWWWWWWWWWWWWWWWWWWWWWWWWWWWWWWWWWWWWWWWWWWWWWWWWW
WWWWWWWWWWWWWWWWWWWWWWWWWWWWWWWWWWWWWWWWWWWWWWWWWWWWWWWWWWWW
WWWWWWWWWWWWWWWWWWWWWWWWWWWWWWWWWWWWWWWWWWWWWWWWWWWWWWWWWWWW
WWWWWWWWWWWWWWWWWWWWWWWWWWWWWWWWWWWWWWWWWWWWWWWWWWWWWWWWWWWW