WWWWWWWWWWWWWWWWWWWWWWWWWWWWWWWWWWWWWWWWWWWWWWWWWWWWWWWWWWWW
WWWWWWWWWWWWWWWWWWWWWWWWWWWWWWWWWWWWWWWWWWWWWWWWWWWWWWWWWWWW
WWWWWWWWWWWWWWWWWWWWWWWWWWWWWWWWWWWWWWWWWWWWWWWWWWWWWWWWWWWW
WWWWWWWWWWWWWWWWWWWWWWWWWWWWWWWWWWWWWWWWWWWWWWWWWWWWWWWWWWWW
WWWWWWWWWWWWWWWWWWWWWWWWWWWWWWWWWWWWWWWWWWWWWWWWWWWWWWWWWWWW
WWWWWWWWWWWWWWWWWWWWWWWWWWWWWWWWWWWWWWWWWWWWWWWWWWWWWWWWWWWW
WWWWWWWWWWWWWWWWWWWWWWWWWWWWWWWWWWWWWWWWWWWWWWWWWWWWWWWWWWWW
WWWWWWWWWWWWWWWWWWWWWWWÊWWWWWWWWWWWWÊWWWWWWWWWWWWWWWWWWWWWWW
WWWWWWWWWWWWWWWWWWWWWWWWWWWWWWWWWWWWWWWWWWWWWWWWWWWWWWWWWWWW
WWWWWWWWWWWWWÊWWWWWWWWWWWWWWWWWWWWWWWWWWWWWWWWÊWWWWWWWWWWWWW
WWWWWWWWWWWWWWWWWWFFFFFFFFFFFFFFFFFFFFFFFFWWWWWWWWWWWWWWWWWW
WWWWWWWWWWWWWWWWFXXMFÉFXEEEEEEEEEEEEEFÉFMXFFWWWWWWWWWWWWWWWW
WWWWWWWWWWWWWWWEEEEEEEEEE...........EEEEEEEEEFWWWWWWWWWWWWWW
WWWWWWWWWWWWWWFEMMMMXXXXX.2.2.2.2.2.......DDEFFWWWWWWWWWWWWW
WWWWWWWWWWWWWÉFEMMXXXXXX...................DEFÉWWWWWWWWWWWWW
WWWWWWWWWWWWFFXEMXXXXXX.................CX..EFFFWWWWWWWWWWWW
WWWWWWWWWWWWXEEEXXXXXX..................CC..EFÉFWWWWWWWWWWWW
WWWWWWWWWWWFXED............N....NFFFFFFF....EMFFFWWWWWWWWWWW
WWWWWWWWWWWÈFE..........DD.N....NFFFFFFF....EFFFFWWWWWWWWWWW
WWWWWWWWWWWFXE......NNNNNNNN....NNNNNNNN...DEFÉFFWWWWWWWWWWW
WWWWWWWWWWFFME....FFFFFFFFFF........D.......EFFFMFWWWWWWWWWW
WWWWWWWWWWFÉFE...FFFFFFFFFFF...............DEXFFXFWWWWWWWWWW
WWWWWWWWWWFFXE...FFFFF..aaaDDDDDDaaa......DDEFÈFFFWWWWWWWWWW
WWWWWWWÊWWFÈFE...FFFC...aDDDDDDDDDDa........EFFFFFWWÊWWWWWWW
WWWWWWWWWWFFXED..FFFC...aDDDDDDDDDDa........EMFFÉFWWWWWWWWWW
WWWWWWWWWWFÈMED..FFFC...aDDDDDDDDDDa...IFF..EFÈFFFWWWWWWWWWW
WWWWWWWWWWFFXE...FFFC...aDDDDDDTDDDa...IFF..EXFFFFWWWWWWWWWW
WWWWWWWWWWFFXE...XXXC...DDDDDDDDDDDD...III..EFÉFFFWWWWWWWWWW
WWWWWWWWWWFÈXE..........DDDTDDDDDDDD........EFFFFFWWWWWWWWWW
WWWWWWWWWWFFFE...DD.....DDDDDDDDDDDD........EEEFÉFWWWWWWWWWW
WWWWWWWWWWFÉFEEE........DDDDDDDDDDDD..........EFFFWWWWWWWWWW
WWWWWWWWWWFFFFME........DDDDDDDDTDDD..........EFFFWWWWWWWWWW
WWWWWWWWWWFMXFFE..III...DDDDDDDDDDDD...CXXX...EFÉFWWWWWWWWWW
WWWWWWWWWWFFFÉFE..FFI...aDDDTDDDDDDa...CFFF...EFFFWWWWWWWWWW
WWWWWWWWWWFFFFXE..FFI...aDDDDDDDDDDa...CFFF..DEFFFWWWWWWWWWW
WWWWWWWÊWWFÈFFFE........aDDDDDDDDDDa...CFFF..DEFÈFWWWWWWWWWW
WWWWWWWWWWFFFFME........aDDDDDDDDDDa...XFFF..DEXFFWWÊWWWWWWW
WWWWWWWWWWFMFÈXE........aaaDDDDDDaaa...FFFF...EMÈFWWWWWWWWWW
WWWWWWWWWWFFFFFE................FFFFFFFFFFF..DEXFFWWWWWWWWWW
WWWWWWWWWWWFFÉFED....DD.........FFFFFFFFFF....EFÉFWWWWWWWWWW
WWWWWWWWWWWFFFMED...NNNNNNNN....NNNNNNNN......EXFWWWWWWWWWWW
WWWWWWWWWWWFFFFE....FFFFFFFN....ND...........DEFÈWWWWWWWWWWW
WWWWWWWWWWWWFFFE....FFFFFFFN....N............DEFFWWWWWWWWWWW
WWWWWWWWWWWWFÉFE..CC..................XXXXXXEEEFWWWWWWWWWWWW
WWWWWWWWWWWWWFMED.CC.................XXXXXXMEXFFWWWWWWWWWWWW
WWWWWWWWWWWWWFFE....................XXXXXXMMEFÉWWWWWWWWWWWWW
WWWWWWWWWWWWWWFE.........1.1.1.1.1.XXXXXMMMMEMFWWWWWWWWWWWWW
WWWWWWWWWWWWWWWEEEEEEEEE...........EEEEEEEEEEFWWWWWWWWWWWWWW
WWWWWWWWWWWWWWWWFFXMFÉFEEEEEEEEEEEEEFÉXXFXFMFWWWWWWWWWWWWWWW
WWWWWWWWWWWWWWWWWWFFFFFFFFFFFFFFFFFFFFFFFFFWWWWWWWWWWWWWWWWW
WWWWWWWWWWWWWÊWWWWWWWWWWWWWWWWWWWWWWWWWWWWWWWWWÊWWWWWWWWWWWW
WWWWWWWWWWWWWWWWWWWWWWWWWWWWWWWWWWWWWWWWWWWWWWWWWWWWWWWWWWWW
WWWWWWWWWWWWWWWWWWWWWWWWWÊWWWWWWWWWÊWWWWWWWWWWWWWWWWWWWWWWWW
WWWWWWWWWWWWWWWWWWWWWWWWWWWWWWWWWWWWWWWWWWWWWWWWWWWWWWWWWWWW
WWWWWWWWWWWWWWWWWWWWWWWWWWWWWWWWWWWWWWWWWWWWWWWWWWWWWWWWWWWW
WWWWWWWWWWWWWWWWWWWWWWWWWWWWWWWWWWWWWWWWWWWWWWWWWWWWWWWWWWWW
WWWWWWWWWWWWWWWWWWWWWWWWWWWWWWWWWWWWWWWWWWWWWWWWWWWWWWWWWWWW
WWWWWWWWWWWWWWWWWWWWWWWWWWWWWWWWWWWWWWWWWWWWWWWWWWWWWWWWWWWW
WWWWWWWWWWWWWWWWWWWWWWWWWWWWWWWWWWWWWWWWWWWWWWWWWWWWWWWWWWWW
WWWWWWWWWWWWWWWWWWWWWWWWWWWWWWWWWWWWWWWWWWWWWWWWWWWWWWWWWWWW