WWWWWWWWWWWWWWWWWWWWWWWWWWWWWWWWWWWWWWWWWWWWWWWWWWWWWWWWWWWW
WWWWWWWWWWWWWWWWWWWWWWWWWWWWWWWWWWWWWWWWWWWWWWWWWWWWWWWWWWWW
WWWWWWWWWWWWWWWWWWWWWWWWWWWWWWWWWWWWWWWWWWWWWWWWWWWWWWWWWWWW
WWWWWWWWWWWWWWWWWWWWWWWWWWWWWWWWWWWWWWWWWWWWWWWWWWWWWWWWWWWW
WWWWWWWWWWWWWWWWWWWWWWWWWWWWWWWWWWWWWWWWWWWWWWWWWWWWWWWWWWWW
WWWWWWWWWWWWWWWWWWWWWWWWWWWWWWWWWWWWWWWWWWWWWWWWWWWWWWWWWWWW
WWWWWWWWWWWWWWWWWWWWWWWWWWFFFFFFFFWWWWWWWWWWWWWWWWWWWWWWWWWW
WWWWWWWWWWWWWWWWWWWFFÈFFFFFFÈFXFÈFFFFFFFFWWWWWWWWWWWWWWWWWWW
WWWWWWWWWWWWWWWWFÈFÈFFFXMFÈFFMXFFFÈFÈFFÈFFFFWWWWWWWWWWWWWWWW
WWWWWWWWWWWWWWFFFFFFFXXFFFFXFMMFXXFFFXFFFMXFFFWWWWWWWWWWWWWW
WWWWWWWWWWWWWFFÈFXFFFXMFFFEEEEEEEEEFFFFFFFFFÈFFWWWWWWWWWWWWW
WWWWWWWWWWWWWÉFFFMXXMFFFMXE.......EXMXXFFMXFFFFWWWWWWWWWWWWW
WWWWWWWWWWWWFFFEEEEEEEEEEEE.2.2.2.EEEEEEEEEEEFÈFWWWWWWWWWWWW
WWWWWWWWWWWWFÈMEXXDDBDDDBB.........BBDDBDDXXEXFFWWWWWWWWWWWW
WWWWWWWWWWWWFFXEXDD..........2.2........D.DXEMFFWWWWWWWWWWWW
WWWWWWWWWWWFFFMEDD.........................BEFÈFFWWWWWWWWWWW
WWWWWWWWWWWXFÈFED.D..YYY...................DEXFFFWWWWWWWWWWW
WWWWWWWWWWWFFFXED...........NNNN...........DEMFÈFWWWWWWWWWWW
WWWWWWWWWWWFÈFFED...........DYCD...TTT.....DEFFFFWWWWWWWWWWW
WWWWWWWWWWÉFFFXEFFFFFD.....................DEFÈFFFWWWWWWWWWW
WWWWWWWWWWFFXFMEFFFFFD..DXX................DEXFFÈFWWWWWWWWWW
WWWWWWWWWWFÈFFFEFFFFFD..DXXXFFFFFXXD.......DEMFFFÉWWWWWWWWWW
WWWWWWWWWWFFFÈFEFFFFFD..DXXXFFFFFXXD..DXX..DEFFFÈFWWWWWWWWWW
WWWWWWWWWWFFÈFXEXXXXXD..DXXXFFFFFXXD..DXXXFFEFÈFFFWWWWWWWWWW
WWWWWWWWWWXFFFXEXXXXXD..DXXXFFFFFXXD..DXXXFFEMFFXFWWWWWWWWWW
WWWWWWWWWWFFÈFMED.......DXXXFFFFFXXD..DXXXFFEXFFMXWWWWWWWWWW
WWWWWWWWWWFFFFFED.......DXXXFFFFFXXD..DXXXFFEXFÈFFWWWWWWWWWW
WWWWWWWWWWFÈFFXED.....................DXXXFFEMFFFFWWWWWWWWWW
WWWWWWWWWWÉFFFFED.BB..................D....DEFÈFÈFWWWWWWWWWW
WWWWWWWWWWFXFÈMED.BB.....BB..BB..BB........DEXFÈFÉWWWWWWWWWW
WWWWWWWWWWFFFFXED........BB..BB..BB.....BB.DEMFFXFWWWWWWWWWW
WWWWWWWWWWXFÈFXED.......................BB.DEFÈFFFWWWWWWWWWW
WWWWWWWWWWFFFFMEFFXXXD.....................DEXFFFÉWWWWWWWWWW
WWWWWWWWWWFFFÈFEFFXXXD..DXXFFFFFXXXD.......DEFFFÈFWWWWWWWWWW
WWWWWWWWWWFÈFFFEFFXXXD..DXXFFFFFXXXD.......DEXFÈFFWWWWWWWWWW
WWWWWWWWWWFFXFXEFFXXXD..DXXFFFFFXXXD..DXXXXXEMFFXXWWWWWWWWWW
WWWWWWWWWWXFFFMEFFXXXD..DXXFFFFFXXXD..DXXXXXEFFFMXWWWWWWWWWW
WWWWWWWWWWFFFÈFED..XXD..DXXFFFFFXXXD..DFFFFFEFÈFFFWWWWWWWWWW
WWWWWWWWWWFÈFFFED.......DXXFFFFFXXXD..DFFFFFEXFFÈFWWWWWWWWWW
WWWWWWWWWWÉFFÈFED................XXD..DFFFFFEFFFFFWWWWWWWWWW
WWWWWWWWWWFFFFXED.....................DFFFFFEFÈFXFWWWWWWWWWW
WWWWWWWWWWWFMFFED.....TTT...DYCD...........DEMFFFWWWWWWWWWWW
WWWWWWWWWWWÉFÈMED...........NNNN...........DEFFÈFWWWWWWWWWWW
WWWWWWWWWWWFFFXED...................CCC..D.DEFFFÉWWWWWWWWWWW
WWWWWWWWWWWFXFXED.........................DDEFÈFFWWWWWWWWWWW
WWWWWWWWWWWWFFMEXD.D........1.1..........DDXEMFFWWWWWWWWWWWW
WWWWWWWWWWWWFFXEXXDDBD.BB.........BB.D.BDDXXEXFÉWWWWWWWWWWWW
WWWWWWWWWWWWFMFEEEEEEEEEEE.1.1.1.EEEEEEEEEEEEMXFWWWWWWWWWWWW
WWWWWWWWWWWWWFFÈFXMFFFXXME.......EFMXXMFFFXFÈFFWWWWWWWWWWWWW
WWWWWWWWWWWWWFXFXMXFXFFFFEEEEEEEEEFFFFFFFXMFFFFWWWWWWWWWWWWW
WWWWWWWWWWWWWWFFFFFXFFXFFÈFMXFMXFÈFXFFFFFFXFFFWWWWWWWWWWWWWW
WWWWWWWWWWWWWWWWFFFFFÈFÈFFFFFFFFFFXFFÈFÈFFFFWWWWWWWWWWWWWWWW
WWWWWWWWWWWWWWWWWWWFFFFFFFÈFXMFFÈFFFFFFFFWWWWWWWWWWWWWWWWWWW
WWWWWWWWWWWWWWWWWWWWWWWWWFFFFFFFFFWWWWWWWWWWWWWWWWWWWWWWWWWW
WWWWWWWWWWWWWWWWWWWWWWWWWWWWWWWWWWWWWWWWWWWWWWWWWWWWWWWWWWWW
WWWWWWWWWWWWWWWWWWWWWWWWWWWWWWWWWWWWWWWWWWWWWWWWWWWWWWWWWWWW
WWWWWWWWWWWWWWWWWWWWWWWWWWWWWWWWWWWWWWWWWWWWWWWWWWWWWWWWWWWW
WWWWWWWWWWWWWWWWWWWWWWWWWWWWWWWWWWWWWWWWWWWWWWWWWWWWWWWWWWWW
WWWWWWWWWWWWWWWWWWWWWWWWWWWWWWWWWWWWWWWWWWWWWWWWWWWWWWWWWWWW
WWWWWWWWWWWWWWWWWWWWWWWWWWWWWWWWWWWWWWWWWWWWWWWWWWWWWWWWWWWW