WWWWWWWWWWWWWWWWWWWWWWWWWWWWWWWWWWWWWWWWWWWWWWWWWWWWWWWWWWWW
WWWWWWWWWWWWWWWWWWWWWWWWWWWWWWWWWWWWWWWWWWWWWWWWWWWWWWWWWWWW
WWWWWWWWWWWWWWWWWWWWWWWWWWWWWWWWWWWWWWWWWWWWWWWWWWWWWWWWWWWW
WWWWWWWWWWWWWWWWWWWWWWWWWWWWWWWWWWWWWWWWWWWWWWWWWWWWWWWWWWWW
WWWWWWWWWWWWWWWWWWWWWWWWWWWWWWWWWWWWWWWWWWWWWWWWWWWWWWWWWWWW
WWWWWWWWWWWWWWWWWWWWWWWWWWWWWWWWWWWWWWWWWWWWWWWWWWWWWWWWWWWW
WWWWWWWWWWWWWWWWWWWWWWWWWWWWWWWWWWWWWWWWWWWWWWWWWWWWWWWWWWWW
WWWWWWWWWWWWWWWWWWWWWWWWWWWWWWWWWWWWWWWWWWWWWWWWWWWWWWWWWWWW
WWWWWWWWWWWWWWWWWWWWWWWWWWWWWWWWWWWWWWWWWWWWWWWWWWWWWWWWWWWW
WWWWWWWWWWWWWWWWWWWWWWWWWWWWWWWWWWWWWWWWWWWWWWWWWWWWWWWWWWWW
WWWWWWWWWWWWFFFFFFFFFFFFFEEEEEEEEEFFFFFFFFFFFFFFWWWWWWWWWWWW
WWWWWWWWWWWÈXMXXFMXFFXFEEE.......EEEMXFFFXMMXFMFFWWWWWWWWWWW
WWWWWWWWWWFXEEEEEEEEEEEE...2.2.2...EEEEEEEEEEEEEFFWWWWWWWWWW
WWWWWWWWWWXEEMXXDDDDBBBB.2.......2.BBBBDDDDDDDDEEFWWWWWWWWWW
WWWWWWWWWWEEMXXXD.....................D.DDDDD.DFEEWWWWWWWWWW
WWWWWWWWWWEMMXXX...........................D...FFEWWWWWWWWWW
WWWWWWWWWWEMXXXXFFFFMMMMMMFFFFFFFFFFFFIIIFFF...FFEWWWWWWWWWW
WWWWWWWWWWEXXXXXDDDDMMMMMMDDDDDDDDDDDDIIIFFF...FFEWWWWWWWWWW
WWWWWWWWWWEXXXXX........................IFFF...FFEWWWWWWWWWW
WWWWWWWWWWEMXXXX........................IFFF...FFEWWWWWWWWWW
WWWWWWWWWWEMXXXXDDDDDDDDDDDDDDDDMMMMMD..DFFF...FEEWWWWWWWWWW
WWWWWWWWWWEEMXXXFFFFFFFFFFFFFFFFFFFMMD..DFFF...EECWWWWWWWWWW
WWWWWWWWWWMEEMXXFFFFFFFFFFFFFFFFFFFMMD..DFFF..EECYWWWWWWWWWW
WWWWWWWWWWXXEEXXFFFF.....FFFFFFFFFFMMD..DFFF.EEF..WWWWWWWWWW
WWWWWWWWWW.XXEEXFFFF.NNN.FFFFFFFFFFMMD..DFFFEEFD..WWWWWWWWWW
WWWWWWWWWW...XEEFFFF.NTN.FFFIIIIBBBMMD..DFFXEFB.Ë.WWWWWWWWWW
WWWWWWWWWW.Ë..MEXFFF.NNN.FFFIDDDDDDDDD..DTXXED....WWWWWWWWWW
WWWWWWWWWW...B.EXXFF.....FFFI...........DXXME.D...WWWWWWWWWW
WWWWWWWWWWD...DEMXXFFFFFFFFFB...........XXXXE...B.WWWWWWWWWW
WWWWWWWWWW.B...EXXXXFFFFFFFFB..BBBBBBBBXXXXME.Ë...WWWWWWWWWW
WWWWWWWWWW...Ë.EMXXXXBBBBBBBB..BFFFFFFFFXXXME...D.WWWWWWWWWW
WWWWWWWWWWCD..DEMXXX...........BFFFFFFFFFXXXEY.B..WWWWWWWWWW
WWWWWWWWWWC..B.EXXXD...........IFFF.....FFXXEX....WWWWWWWWWW
WWWWWWWWWW....YEXXTD..DDDDDDDDDIFFF.NNN.FFFXEM..Ë.WWWWWWWWWW
WWWWWWWWWW.Ë.DFEXFFD..DMMBBBIIIIFFF.NTN.FFFFEEX..DWWWWWWWWWW
WWWWWWWWWW...FEEFFFD..DMMFFFFFFFFFF.NNN.FFFFXEEXYYWWWWWWWWWW
WWWWWWWWWW..FEE.FFFD..DMMFFFFFFFFFF.....FFFFXXEEXXWWWWWWWWWW
WWWWWWWWWWYCEE..FFFD..DMMFFFFFFFFFFFFFFFFFFFXXMEEMWWWWWWWWWW
WWWWWWWWWWCEE...FFFD..DMMFFFFFFFFFFFFFFFFFFFXXXMEEWWWWWWWWWW
WWWWWWWWWWEEF...FFFD..DMMMMMDDDDDDDDDDDDDDDDXXXMMEWWWWWWWWWW
WWWWWWWWWWEFF...FFFI........................XXXXMEWWWWWWWWWW
WWWWWWWWWWEFF...FFFI........................XXXXXEWWWWWWWWWW
WWWWWWWWWWEFF...FFFIIIDDDDDDDDDDDDMMMMMMDDDDXXXXXEWWWWWWWWWW
WWWWWWWWWWEFF...FFFIIIFFFFFFFFFFFFMMMMMMFFFFXXXXMEWWWWWWWWWW
WWWWWWWWWWEFF...D...........................XXXMMEWWWWWWWWWW
WWWWWWWWWWEEFD.DDDDD.......................DXXXMEEWWWWWWWWWW
WWWWWWWWWWFEEDDDDDDDDBBBB.1.......1.BBBBDDDDXXMEEXWWWWWWWWWW
WWWWWWWWWWFFEEEEEEEEEEEEE...1.1.1...EEEEEEEEEEEEXFWWWWWWWWWW
WWWWWWWWWWWFFFMMXFFFFFXMEEE.......EEEXMXFFXXFMXÈFWWWWWWWWWWW
WWWWWWWWWWWWFFFFFFFFFFFFFMEEEEEEEEEFFFFFFFFFFFFFWWWWWWWWWWWW
WWWWWWWWWWWWWWWWWWWWWWWWWWWWWWWWWWWWWWWWWWWWWWWWWWWWWWWWWWWW
WWWWWWWWWWWWWWWWWWWWWWWWWWWWWWWWWWWWWWWWWWWWWWWWWWWWWWWWWWWW
WWWWWWWWWWWWWWWWWWWWWWWWWWWWWWWWWWWWWWWWWWWWWWWWWWWWWWWWWWWW
WWWWWWWWWWWWWWWWWWWWWWWWWWWWWWWWWWWWWWWWWWWWWWWWWWWWWWWWWWWW
WWWWWWWWWWWWWWWWWWWWWWWWWWWWWWWWWWWWWWWWWWWWWWWWWWWWWWWWWWWW
WWWWWWWWWWWWWWWWWWWWWWWWWWWWWWWWWWWWWWWWWWWWWWWWWWWWWWWWWWWW
WWWWWWWWWWWWWWWWWWWWWWWWWWWWWWWWWWWWWWWWWWWWWWWWWWWWWWWWWWWW
WWWWWWWWWWWWWWWWWWWWWWWWWWWWWWWWWWWWWWWWWWWWWWWWWWWWWWWWWWWW
WWWWWWWWWWWWWWWWWWWWWWWWWWWWWWWWWWWWWWWWWWWWWWWWWWWWWWWWWWWW
WWWWWWWWWWWWWWWWWWWWWWWWWWWWWWWWWWWWWWWWWWWWWWWWWWWWWWWWWWWW