WWWWWWWWWWWWWWWWWWWWWWWWWWWWWWWWWWWWWWWWWWWWWWWWWWWWWWWWWWWW
WWWWWWWWWWWWWWWWWWWWWWWWWWWWWWWWWWWWWWWWWWWWWWWWWWWWWWWWWWWW
WWWWWWWWWWWWWWWWWWWWWWWWWWWWWWWWWWWWWWWWWWWWWWWWWWWWWWWWWWWW
WWWWWWWWWWWWWWWWWWWWWWWWWWWWWWWWWWWWWWWWWWWWWWWWWWWWWWWWWWWW
WWWWWWWWWWWWWWWWWWWWWWWWWWWWWWWWWWWWWWWWWWWWWWWWWWWWWWWWWWWW
WWWWWWWWWWWWWWWWWWWWWWWWWWWWWWWWWWWWWWWWWWWWWWWWWWWWWWWWWWWW
WWWWWWWWWWWWWWWWWWWWWWWWWWWWWWWWWWWWWWWWWWWWWWWWWWWWWWWWWWWW
WWWWWWWWWWWWWWWWWWWWWWWWWWWWWWWWWXXXXXXXXWWWWWWWWWWWWWWWWWWW
WWWWWWWWWWWWWWWWWWWWWWWWWWWWWWWWWXFFFFFCMWWWWWWWWWWWWWWWWWWW
WWWWWWWWWWWWWWWWWWWWWWWWWWWWWXXXXXF.....XXXXXXWWWWWWWWWWWWWW
WWWWWWWWWWWWWWWWWWWWWWWWWWWWWNBBCT......CYYYYMWWWWWWWWWWWWWW
WWWWWWWWWWWWWWWNNNNNNNNNNNNNNNB...........TYYMWWWWWWWWWWWWWW
WWWWWWWWWWWWWWWNTTB.D..D...DD....D.D.......CYMWWWWWWWWWWWWWW
WWWWWWWWWWWWWNNNTC....2.2.2.2.2...D........CCXXWWWWWWWWWWWWW
WWWWWWWWWWWWWNYY.................D...........FNWWWWWWWWWWWWW
WWWWWWWWWWWWWNCC...D.D......................FFNWWWWWWWWWWWWW
WWWWWWWWWWWWWN....DDD.....NNNNNN....CYC....FFFNWWWWWWWWWWWWW
WWWWWWWWWWWWWNF....DD......D.DDNF..BYYT....FFFNWWWWWWWWWWWWW
WWWWWWWWWWWWWNFF..............DNFFBBBBB....FCCNWWWWWWWWWWWWW
WWWWWWWWWWWWWNFFF...............FFFFFFF....FCYNWWWWWWWWWWWWW
WWWWWWWWWWWWWNFFFF..D...........FFFFFFF....FYYNWWWWWWWWWWWWW
WWWWWWWWWWWWWNFFXXBBXX..........FFFWWWWa..aWWWWWWWWWWWWWWWWW
WWWWWWWWWWWWWNFFX....XD.F.......FFWWWWWa..aWWWWWWWWWWWWWWWWW
WWWWWWWWWWWWWNFFB....B..FFC.....FFWWWWWa..aWWWWWWWWWWWWWWWWW
WWWWWWWWWWWWWNFFB....B..FFCC....FFWWWYC....TYYNWWWWWWWWWWWWW
WWWWWWWWWWWWWNFFX....X..FFYC....FFWWWCC....CYYNWWWWWWWWWWWWW
WWWWWWWWWWWWWNFFXXBBXXD.FFFF....FFBBB.......CYNWWWWWWWWWWWWW
WWWWWWWWWWWWWNF.........FFFF....FFBBB..D......NWWWWWWWWWWWWW
WWWWWWWWWWWWWN..........WWWWa..aWWWWW...DD.D..NWWWWWWWWWWWWW
WWWWWWWWWWWWWN...D...D.WWWWWa..aWWWWW...DDD...NWWWWWWWWWWWWW
WWWWWWWWWWWWWND...DD...WWWWWa..aWWWWW..D.....DNWWWWWWWWWWWWW
WWWWWWWWWWWWWN....DD...WWWWWa..aWWWW.........DNWWWWWWWWWWWWW
WWWWWWWWWWWWWN...D.....BBBFF....FFFF.........FNWWWWWWWWWWWWW
WWWWWWWWWWWWWNT........BBBFF....FFFF.DXXBBXXFFNWWWWWWWWWWWWW
WWWWWWWWWWWWWNYCT....CYWWWFF....CYFF..X....XFFNWWWWWWWWWWWWW
WWWWWWWWWWWWWNYYY....YYWWWFF....CCFF..B....BFFNWWWWWWWWWWWWW
WWWWWWWWWWWWWWWWWa..aWWWWWFF.....CFF..B....BFFNWWWWWWWWWWWWW
WWWWWWWWWWWWWWWWWa..aWWWWWFF.......F..X....XFFNWWWWWWWWWWWWW
WWWWWWWWWWWWWWWWWa..aWWWWFFF..........XXBBXXFFNWWWWWWWWWWWWW
WWWWWWWWWWWWWNYYF....FFFFFFF..............FFFFNWWWWWWWWWWWWW
WWWWWWWWWWWWWNYCF....FFFFFFF...............FFFNWWWWWWWWWWWWW
WWWWWWWWWWWWWNCCF....BBBBBFFND........D.....FFNWWWWWWWWWWWWW
WWWWWWWWWWWWWNFFF....TYCB..FN.DD.......DD....FNWWWWWWWWWWWWW
WWWWWWWWWWWWWNFFF.....TC....NNNNNN.....DD.....NWWWWWWWWWWWWW
WWWWWWWWWWWWWNFF......................D.....TCNWWWWWWWWWWWWW
WWWWWWWWWWWWWNF....D..D.....................CYNWWWWWWWWWWWWW
WWWWWWWWWWWWWXXTT...D........1.1.1.1.1....CYNNNWWWWWWWWWWWWW
WWWWWWWWWWWWWWMYC...............D.D...DD.TYYNWWWWWWWWWWWWWWW
WWWWWWWWWWWWWWMYYC............NNNNNNNNNNNNNNNWWWWWWWWWWWWWWW
WWWWWWWWWWWWWWMYYYYC.D....CC..NWWWWWWWWWWWWWWWWWWWWWWWWWWWWW
WWWWWWWWWWWWWWXXXXXXF.....XXXXXWWWWWWWWWWWWWWWWWWWWWWWWWWWWW
WWWWWWWWWWWWWWWWWWWMFFFFFTXWWWWWWWWWWWWWWWWWWWWWWWWWWWWWWWWW
WWWWWWWWWWWWWWWWWWWXXXXXXXXWWWWWWWWWWWWWWWWWWWWWWWWWWWWWWWWW
WWWWWWWWWWWWWWWWWWWWWWWWWWWWWWWWWWWWWWWWWWWWWWWWWWWWWWWWWWWW
WWWWWWWWWWWWWWWWWWWWWWWWWWWWWWWWWWWWWWWWWWWWWWWWWWWWWWWWWWWW
WWWWWWWWWWWWWWWWWWWWWWWWWWWWWWWWWWWWWWWWWWWWWWWWWWWWWWWWWWWW
WWWWWWWWWWWWWWWWWWWWWWWWWWWWWWWWWWWWWWWWWWWWWWWWWWWWWWWWWWWW
WWWWWWWWWWWWWWWWWWWWWWWWWWWWWWWWWWWWWWWWWWWWWWWWWWWWWWWWWWWW
WWWWWWWWWWWWWWWWWWWWWWWWWWWWWWWWWWWWWWWWWWWWWWWWWWWWWWWWWWWW
WWWWWWWWWWWWWWWWWWWWWWWWWWWWWWWWWWWWWWWWWWWWWWWWWWWWWWWWWWWW