WWWWWWWWWWWWWWWWWWWWWWWWWWWWWWWWWWWWWWWWWWWWWWWWWWWWWWWWWWWW
WWWWWWWWWWWWWWWWWWWWWWWWWWWWWWWWWWWWWWWWWWWWWWWWWWWWWWWWWWWW
WWWWWWWWWWWWWWWWWWWWWWWWWWWWWWWWWWWWWWWWWWWWWWWWWWWWWWWWWWWW
WWWWWWWWWWWWWWWWWWWWWWWWWWWWWWWWWWWWWWWWWWWWWWWWWWWWWWWWWWWW
WWWWWWWWWWWWWWWWWWWWWWWWWWWWWWWWWWWWWWWWWWWWWWWWWWWWWWWWWWWW
WWWWWWWWWWWWWWWWWWWWWWWWWWWWWWWWWWWWWWWWWWWWWWWWWWWWWWWWWWWW
WWWWWWWWWWWWWWWWWWWWWWWWWWWWWWWWWWWWWWWWWWWWWWWWWWWWWWWWWWWW
WWWWWWWWWWWWWWWWWWWWWWWWWWWWWWWWWWWWWWWWWWWWWWWWWWWWWWWWWWWW
WWWWWWWWWWWWWWWWWWWWWWWWWWWWWWWWWWWWWWWWWWWWWWWWWWWWWWWWWWWW
WWWWWWWWWWWWWWWWWWWWWWWWWWWWWWWWWWWWWWWWWWWWWWWWWWWWWWWWWWWW
WWWWWWWWWWWWWWWWWWWWWWWWWWWWWWWWWWWWWWWWWWWWWWWWWWWWWWWWWWWW
WWWWWWWWWWWWWWWWWWWWWWWWWWWWWWWWWWWWWWWWWWWWWWWWWWWWWWWWWWWW
WWWWWWWWWWWWWWWWWWWWWWWWWWWWWWWWWWWWWWWWWWWWWWWWWWWWWWWWWWWW
WWWWWWWWWWWWWWWWWWWWWWWWWWWWWWWWWWWWWWWWWWWWWWWWWWWWWWWWWWWW
WWWWWWWWWWWWWWWWWWWWWWWWWWWWWWWWWWWWWWWWWWWWWWWWWWWWWWWWWWWW
WWWWWWWWWWWWWWWWWWWWWWWWWWWWWWWWWWWWWWWWWWWWWWWWWWWWWWWWWWWW
WWWWWWWWWWWWWEEEEEEEEEEEEEEEEEEEEEEEEEEEEEEEEEEWWWWWWWWWWWWW
WWWWWWWWWWWWWEMC....D...FFFFMMMM.FFF.D......CMEWWWWWWWWWWWWW
WWWWWWWWWWWWWECB.............YY.............BCEWWWWWWWWWWWWW
WWWWWWWWWWWWWEFF...........................DFFEWWWWWWWWWWWWW
WWWWWWWWWWWWWEFFD...NNNN...FF...............FFEWWWWWWWWWWWWW
WWWWWWWWWWWWWEFF...........FFFF.....NNNN....FFEWWWWWWWWWWWWW
WWWWWWWWWEEEEE.............NNNN.....CC........EEEEEWWWWWWWWW
WWWWWWWWWEDDDY................................YDDDEWWWWWWWWW
WWWWWWWWWE..D..................................D..EWWWWWWWWW
WWWWWWWWWE.......NX..1.....CC............XN......7EWWWWWWWWW
WWWWWWWWWE6......ND........CC.........2..DN.......EWWWWWWWWW
WWWWWWWWWE.......N...1.....DD...FFT.......N......7EWWWWWWWWW
WWWWWWWWWE6.....................FFT...2..........DEWWWWWWWWW
WWWWWWWWWE....B......1.......................B...7EWWWWWWWWW
WWWWWWWWWE6...B.......................2......B....EWWWWWWWWW
WWWWWWWWWE...........1...TFF.....................7EWWWWWWWWW
WWWWWWWWWE6......N.......TFF...DD.....2...N......DEWWWWWWWWW
WWWWWWWWWE.......ND..1.........CC........DN......7EWWWWWWWWW
WWWWWWWWWE6......NX............CC.....2..XN.......EWWWWWWWWW
WWWWWWWWWE..D..................................D..EWWWWWWWWW
WWWWWWWWWEDDDY................................YDDDEWWWWWWWWW
WWWWWWWWWEEEEE........CC.....NNNN.............EEEEEWWWWWWWWW
WWWWWWWWWWWWWEFF....NNNN.....FFFF...........FFEWWWWWWWWWWWWW
WWWWWWWWWWWWWEFF...............FF...NNNN...DFFEWWWWWWWWWWWWW
WWWWWWWWWWWWWEFFD...........................FFEWWWWWWWWWWWWW
WWWWWWWWWWWWWECB.............YY.............BCEWWWWWWWWWWWWW
WWWWWWWWWWWWWEMC......D.FFFFMMMMFFFF...D....CMEWWWWWWWWWWWWW
WWWWWWWWWWWWWEEEEEEEEEEEEEEEEEEEEEEEEEEEEEEEEEEWWWWWWWWWWWWW
WWWWWWWWWWWWWWWWWWWWWWWWWWWWWWWWWWWWWWWWWWWWWWWWWWWWWWWWWWWW
WWWWWWWWWWWWWWWWWWWWWWWWWWWWWWWWWWWWWWWWWWWWWWWWWWWWWWWWWWWW
WWWWWWWWWWWWWWWWWWWWWWWWWWWWWWWWWWWWWWWWWWWWWWWWWWWWWWWWWWWW
WWWWWWWWWWWWWWWWWWWWWWWWWWWWWWWWWWWWWWWWWWWWWWWWWWWWWWWWWWWW
WWWWWWWWWWWWWWWWWWWWWWWWWWWWWWWWWWWWWWWWWWWWWWWWWWWWWWWWWWWW
WWWWWWWWWWWWWWWWWWWWWWWWWWWWWWWWWWWWWWWWWWWWWWWWWWWWWWWWWWWW
WWWWWWWWWWWWWWWWWWWWWWWWWWWWWWWWWWWWWWWWWWWWWWWWWWWWWWWWWWWW
WWWWWWWWWWWWWWWWWWWWWWWWWWWWWWWWWWWWWWWWWWWWWWWWWWWWWWWWWWWW
WWWWWWWWWWWWWWWWWWWWWWWWWWWWWWWWWWWWWWWWWWWWWWWWWWWWWWWWWWWW
WWWWWWWWWWWWWWWWWWWWWWWWWWWWWWWWWWWWWWWWWWWWWWWWWWWWWWWWWWWW
WWWWWWWWWWWWWWWWWWWWWWWWWWWWWWWWWWWWWWWWWWWWWWWWWWWWWWWWWWWW
WWWWWWWWWWWWWWWWWWWWWWWWWWWWWWWWWWWWWWWWWWWWWWWWWWWWWWWWWWWW
WWWWWWWWWWWWWWWWWWWWWWWWWWWWWWWWWWWWWWWWWWWWWWWWWWWWWWWWWWWW
WWWWWWWWWWWWWWWWWWWWWWWWWWWWWWWWWWWWWWWWWWWWWWWWWWWWWWWWWWWW
WWWWWWWWWWWWWWWWWWWWWWWWWWWWWWWWWWWWWWWWWWWWWWWWWWWWWWWWWWWW
WWWWWWWWWWWWWWWWWWWWWWWWWWWWWWWWWWWWWWWWWWWWWWWWWWWWWWWWWWWW