WWWWWWWWWWWWWWWFFFFWWWWWWWWWWFFFWWWWWWWWWWWWWWFFFWWWWWWWWWWW
WWWWWWWWWWWWWWFFFFFWWWWWWWWWFFFFFWWWWWWWWWWWFFF»FFFWWWWWWWWW
WWWWWWWWWWWWWFFFFFFFFWWWWWWFCFFFCFWWWWWWWWWWFFFFFFFFFWWWWWWW
WWWWWWWWWWWWFFÀFYCFFFWWWWWFFCFCFCFFWWWWWWWWWFFFXMFFFFWWWWWWW
WWWWWWWWWWWWWFFFCYFFFFWWWWFFCYCYCFFWWWWWWWWWFFFXMFFWWWWWWWWW
WWWWWWWWWWWWWWFFFFFFWWWWWWFFCCFCCFFWWWWWWWWWFFFNNFFW WWWWWWW
WWWWFWWWWWWW WWFFFWWWWWWWWFFFFFFFFFWWWWWWWWWWFFFFFFWWWWWWWWW
WWWFFFWWW WWWWWWWWWWWWWWWWWFFWWWFFWWWWWWWWWWWWWFFFFWWWWWWW W
WWFFFFFFWWWWWWWWWWWFFFWWWWWWWW WWWWWWFFFFWWWWWWWWWWWWWWWWWWW
WWFXMTFFFWWWWWFFFFFFFFFFWWWWWWWWWWWFFFFFFFFWWWWWWWWWWWWFFFFF
WFFYTMFFFWW WFFFFFÀFEEEEEEEEEEEEEEEEEEEEFFFFFWWWWWWW WFFFFFF
WFFMXTFFFWWWWFFFFFFFECFFF..D.....D.FFFCE……FFFFFWWWWWWWFFFTXF
WFFFFFFFWWWWFFFEEEEEECFF....2.2.2...FFCEEEEEEFFFWW WWWF»FXTF
WWFF»FFWWWWWFFFEFFFYY..................YYFFFEFFFFWWWWWFFFFFF
WWWWFFWWWWWF»FFEFFFF.........2.2........FFFFEFFFFFFWWWWWF…FF
WWWWWWWWWWWFFFFEFFF......................FFFE»FFFFFFWWWWWWWW
WWWWWWWWWWFFFFFEFF..XMXM..................FFEFFFFF»FFWWWWWWW
WWWWWWWWFFFFFEEEF.................TTT......FEEEFFFFFFWWWWWWW
WWWWWWWFFFFF»E.....................DX.........EFFFFFFFWWWWWW
WWWWWWFFF»FEEE....YC.....NNNN.................EEEFFFFFFWWWWW
WWWWWWFFFF…EFF....CY...WWWWFFFFFF.......NNN...FFE…FFFFFW WWW
WWWWWFFFFEEEFF....FFFFFWWWWFFFFFFWWWTFFFFFD...FFEEE»FFFWWWWW
WWWWFFFFFE....g...FFFFFWWD.....FFWWWTFFFFF......g.EFFFFWWWWW
WWWWFFFFFE..g......DFF......g.g.......FF......g...EFFÀFFFWWW
WW WFFFFFE.....g....FF................FF...DM....gEFFFFFFWWW
WWWWFFFFFEF..g.....MWW......g.g..ID...WW...XX..g.FEFFFFFFWWW
WWWFFFFFFEF........XWW...I.......I....WW...II....FEFFFFFFWWW
WWWFFFF»FEF........CTM..DIFF...XMI....TX.........FEFFFFFFWWW
WWWFFFF…FEFF..X.....FF..gITX..g.D...g.FF........FFEFFFFFFW W
WWWFF»…FFEFF.NNNN...FFg.....g.....g...FF.....D.FFFEFFFFFFWWW
WWWFFFFFFEFF..D.....FF...g.....g.....gFF...NNNNFFFEFF…»FFWWW
W WFFFFFFEFF........FF.g...D.g..XTIg..FF.....X..FFEF…FFFFWWW
WWWFFFFFFEF.........XT....IMX...FFID..MTC........FEF»FFFFWWW
WWWFFFFFFEF....II...WW....I.......I...WWX........FEFFFFFFWWW
WWWFFFFFFEF.g..XX...WW...DI..g.g......WWM.....g..FEFFFFFWWWW
WWWFFFFFFEg....MD...FF................FF....g.....EFFFFFW WW
WWWFFFÀFFE...g......FF.......g.g......FFD......g..EFFFFFWWWW
WWWWWFFFFE.g......FFFFFTWWWFF.....DWWFFFFF...g....EFFFFFWWWW
WWWWWFFF»EEEFF...DFFFFFTWWWFFFFFFWWWWFFFFF....FFEEEFFFFWWWWW
WWW WFFFFF…EFF...NNN.......FFFFFFWWWW...YC....FFE…FFFFWWWWWW
WWWWWFFFFFFEEE.................NNNN.....CY....EEEF»FFFWWWWWW
WWWWWWFFFFFFFE.........XD.....................E»FFFFFWWWWWWW
WWWWWWWFFFFFFEEEF......TTT.................FEEEFFFFFWWWWWWWW
WWWWWWWFF»FFFFFEFF..................MXMX..FFEFFFFFWWWWWWWWWW
WWWWWWWWFFFFFF»EFFF......................FFFEFFFFWWWWWWWWWWW
FF…FWWWWWFFFFFFEFFFF........1.1.........FFFFEFF»FWWWWWFFWWWW
FFFFFFWWWWWFFFFEFFFYY..................YYFFFEFFFWWWWWFF»FFWW
FTXF»FWWW WWFFFEEEEEECFF...1.1.1....FFCEEEEEEFFFWWWWFFFFFFFW
FXTFFFWWWWWWWFFFFF……ECFFF.D.....D..FFFCEFFFFFFFWWWWFFFTXMFFW
FFFFFFW WWWWWWWFFFFFEEEEEEEEEEEEEEEEEEEEFÀFFFFFW WWFFFMTYFFW
FFFFFWWWWWWWWWWWWFFFFFFFFWWWWWWWWWWWFFFFFFFFFFWWWWWFFFTMXFWW
WWWWWWWWWWWWWWWWWWWFFFFWWWWWW WWWWWWWWFFFWWWWWWWWWWWFFFFFFWW
W WWWWWWWFFFFWWWWWWWWWWWWWFFWWWFFWWWWWWWWWWWWWWWWW WWWFFFWWW
WWWWWWWWWFFFFFFWWWWWWWWWWFFFFFFFFFWWWWWWWWFFFWW WWWWWWWFWWWW
WWWWWWW WFFNNFFFWWWWWWWWWFFCCFCCFFWWWWWWFFFFFFWWWWWWWWWWWWWW
WWWWWWWWWFFMXFFFWWWWWWWWWFFCYCYCFFWWWWFFFFYCFFFWWWWWWWWWWWWW
WWWWWWWFFFFMXFFFWWWWWWWWWFFCFCFCFFWWWWWFFFCYFÀFFWWWWWWWWWWWW
WWWWWWWFFFFFFFFFWWWWWWWWWWFCFFFCFWWWWWWFFFFFFFFWWWWWWWWWWWWW
WWWWWWWWWFFF»FFFWWWWWWWWWWWFFFFFWWWWWWWWWFFFFFWWWWWWWWWWWWWW
WWWWWWWWWWWFFFWWWWWWWWWWWWWWFFFWWWWWWWWWWFFFFWWWWWWWWWWWWWWW