WWWWWWWWWWWWWWWWWWWWWWWWWWWWWWWWWWWWWWWWWWWWWWWWWWWWWWWWWWWW
WWWWWWWWWWWWWWWWWWWWWWWWWWWWWWWWWWWWWWWWWWWWWWWWWWWWWWWWWWWW
WWWWWWWWWWWWWWWWWWWWWWWWWWWWWWWWWWWWWWWWWWWWWWWWWWWWWWWWWWWW
WWWWWWWWWWWWWWWWWWWWWWWWWWWWWWWWWWWWWWWWWWWWWWWWWWWWWWÊWWWWW
WWWWWWWWWWWWWWWWWWWWWWWWWWWWWWWWWWWWWWWWWÊWWWWWWWWWWWWWWWWWW
WWWWWWWWWWWWÊWWWWWWWWWWWÊWWWWWWWWWWWWWWWWWWWWWWWWWWWWWWWWWWW
WWWWWWWWWWWWWWWWWWWWWWWWWWWWWWWÊWWWWWWWWWWWWWWWWWWWWWWWWWWWW
WWWWWWWWWWWWWWWWWWWWWWWWWWWWWWWWWWWWWWWWWWWWWÊWWWWWWWWWWWWWW
WWWWWWWWWWWWWWWWWWWWWWWWWWWWWÊWWWWWWWÊWWWWWWWWWWWWWWWWWWWWWW
WWWWWWWWWWWWWWWWWWÊWWWWWWWWWWWWWWWWWWWWWWWWWWWWWWWWÊWWWWWWWW
WWWWWWWWWWWWWWWWWWWWWWWW......................WWWWWWWWWWWWWW
WWWWWWWWWWWWWWWWWWWW.....EEEEEEEEEEEEEEEEEEEE..WWWWWWWWWWWWW
WWWWWWWWWÊWWWWWWWW...EEEEEFFFFFFFFFFFFFFFFFFEE..WWWWWWWWWWWW
WWWWWWWWWWWWWWWWW..EEE.........D..........FFFEE..WWWWWWWWWWW
WWWWWWWWWWWWÊWWW..EEF.....2.2.2.2.2.I......FFFEE.WWWWÊWWWWWW
WWWWWWWWWWWWWWW..EEF.............D..I...D...FFFE.WWWWWWWWWWW
WWWWWWWWWWWWWW..EEFF.......D........I...DD.D.FFE.WWWÊWWWWWWW
WWWWWWWWWWWWWW.EEFF.....II...............DD..FFE.WWWWWWWWWWW
WWWWWWWWWWWWW..EFF.....DYY...NNNN...D..X.....FFE.WWWWWWWWWWW
WWWWWWWWWWWWW.EEFF.C.d..MM...FFFF..D...YX..D.YYE.WWWWWWWWWWW
WWWWWWWWWWWWW.EFF.......TT..............YX...YYE.WWWWWWWWWWW
WWWWWWWWWWWWW.EFF.......XX......I........Y...FFE.WWWWWWWWWWW
WWWWWWWWWWWW..EF....M...CC.g.g..I.g.g........FFE.WWWWWWWWWWW
WWWWWWWWWWWW.EEF...MM...........I......D.....FFE.WWWWWWWWWWW
WWWWWWWWWWWW.EFF..MM.g.g...g.ge.E.g.g........FFE.WWWWWWWWWWW
WWWWWWWWÊWWW.EFF.MM.............E............FFE.WWWÊWWWWWWW
WWWWWWWWWWW..EFF.....g.g.EEEaaEEE...EEg.g.CCCFFE.WWWWWWWWWWW
WWWWWWWWWWW.EEFF.........FFF..FFF.........c..FFE.WWWWWWWWWWW
WWWWWWWWWWW.EFF.....FF..FFFF.g....D...g.g....FFE.WWÊWWWWWWWW
WWWWWWWWWWW.EFF.II..EEaaEEEE...g.............FFE.WWWWWWWWWWW
WWWWÊWWWWWW.EFF.............g...EEEEaaEE..II.FFE.WWWWWWWWWWW
WWWWWWWWWWW.EFF.d..g.g........g.FFFF..FF.....FFE.WWWWWWWWWWW
WWWWWWWWÊWW.EFF............FFF..FFF.........FFEE.WWWWWWWWWWW
WWWWWWWWWWW.EFFCCC.g.gEE...EEEaaEEE.g.g.....FFE..WWWWWWWWWWW
WWWWWWWWWWW.EFF............Ee............MM.FFE.WWWWWWWÊWWWW
WWWWWWWWWWW.EFF..DD....g.g.E..g.g...g.g.MM..FFE.WWWWWWWWWWWW
WWWWWWWWWWW.EFF.....D......I...........MM...FEE.WWWWWWWWWWWW
WWWWWWWWWWW.EFF........g.g.I..g.g.CC...M....FE..WWWWWWWWWWWW
WWWWWWWWWWW.EFF...Y........I......MM.......FFE.WWWWWWWWWWWWW
WWWWWWWWWWW.EYY...XY..............TT.c.....FEE.WWWWWWWWWWWWW
WWWWWÊWWWWW.EYY.D..XY......FFFF...XX....C.FFE..WWWWWWWWWWWWW
WWWWWWWWWWW.EFF.....X......NNNN...YY......FEE.WWWWWWWWWWWWWW
WWWWWWWWÊWW.EFF..D................II.....FFE..WWWWÊWWWWWWWWW
WWWWWWWWWWW.EFF..DDD.D.I......D.........FFEE.WWWWWWWWWWWWWWW
WWWWWWWWWWW.EFFF..DD...I............D..FFEE..WWWWWWWWWWWWWWW
WWWWWWWWWWW.EEFFF.D.D..I.1.1.1.1.1....FEEE..WWWWWWWWWWWWWWWW
WWWWWÊWWWWW..EEFFF...................EEE...WWWWWWWWWWWWWWWWW
WWWWWWWWWWWW..EEFFFFFFFFFFFFFFFFFFEEEE...WWWWWWWWWWWWWWWWWWW
WWWWWWWWWWWWW..EEEEEEEEEEEEEEEEEEEE....WWWWWWWWWWWWWWWWWWWWW
WWWWWWWWWWWWWW......................WWWWWWWWWWWWWWÊWWWWWWWWW
WWWWWWWWWWWWWWWWWWWWWWWWWWWWWWWWWWWWWWWWWWWÊWWWWWWWWWWWWWWWW
WWWWWWWWWWWWWWWWWWWWWWWWWWWWWWWWWWWWWWWWWWWWWWWWWWWWWWWWWWWW
WWWWWWWWWWWWWWWWWWÊWWWWWWWWWWWWWWÊWWWWWWWWWWWWWWWWWWWWWWWWWW
WWWWWWWWWWÊWWWWWWWWWWWWWWWWWWWWWWWWWWWWWWWWWWWWWWWWWWWWWWWWW
WWWWWWWWWWWWWWWWWWWWWWWWWÊWWWWWWWWWWWWWWWWWWWWWWWWWWWWWWWWWW
WWWWWWWWWWWWWWWWWWWWWWWWWWWWWWWWWWWWWWWWWWWWWWWWWWWWWWWWWWWW
WWWWWWWWWWWWWWWWWWWWWWWWWWWÊWWWWWWWWWWWWWWÊWWWWWWWWWWWWWWWWW
WWWWWWWWWWWWWWWWWWWWWWWWWWWWWWWWWWWWWWWWWWWWWWWWWWWWWWWWWWWW
WWWWWWWWWWWWWWWWWWWWWWWWWWWWWWWWWWWWWWWWWWWWWWWWWWWWWWWWWWWW
WWWWWWWWWWWWWWWWWWWWWWWWWWWWWWWWWWWWWWWWWWWWWWWWWWWWWWWWWWWW