WWWWWWWWWWWWWWWWWWWWWWWWWWWWWWWWWWWWWWWWWWWWWWWWWWWWWWWWWWWW
WWWWWWWWWWWWWWWWWWWWWWWWWWWWWWWWWWWWWWWWWWWWWWWWWWWWWWWWWWWW
WWWWWWWWWWWWWWWWWWWWWWWWWWWWWWWWWWWWWWWWWWWWWWWWWWWWWWWWWWWW
WWWWWWWWWWWWWWWWWWWWWWWWWWWWWWWWWWWWWWWWWWWWWWWWWWWWWWWWWWWW
WWWWWWWWWWWWWWWWWWWWWWWWWWWWWWWWWWWWWWWWWWWWWWWWWWWWWWWWWWWW
WWWWWWWWWWWWWWWWWWWWWWWWWWWWWWWWWWWWWWWWWWWWWWWWWWWWWWWWWWWW
WWWWWWWWWWWWWWWWWWWWWWWWWWWWWWWWWWWWWWWWWWWWWWWWWWWWWWWWWWWW
WWWWWWWWWWWWWWWWWWWWWWWWWWWWWWWWWWWWWWWWWWWWWWWWWWWWWWWWWWWW
WWWWWWWWWWWWWWWWWWWWWWWWWWWWWWWWWWWWWWWWWWWWWWWWWWWWWWWWWWWW
WWWWWWWWWWWWWWWWWWWWWWWWWWWWWWWWWWWWWWWWWWWWWWWWWWWWWWWWWWWW
WWWWWWWWWWWWWWWWWWWWWWWWWWWWWWWWWWWWWWWWWWWWWWWWWWWWWWWWWWWW
WWWWWWWWWWWWWWWWWWWWWWWWWWWWWWWWWWWWWWWWWWWWWWWWWWWWWWWWWWWW
WWWWWWWWWWW......................................WWWWWWWWWWW
WWWWWWWWWWW......................................WWWWWWWWWWW
WWWWWWWWWWW..EEEEEEEEEEEEEEEEEEEEEEEEEEEEEEEEEE..WWWWWWWWWWW
WWWWWWWWWWW..E......XXXMMMMMMM......XXXMMMFFFFE..WWWWWWWWWWW
WWWWWWWWWWW..E.........MMMMMMM.........MMMFFFFE..WWWWWWWWWWW
WWWWWWWWWWW..E..........FFFFFFFF..........FFFFE..WWWWWWWWWWW
WWWWWWWWWWW..E..MMFFF...FFFFFFFFFFFF........FFE..WWWWWWWWWWW
WWWWWWWWWWW..EFFFFFFF.......FFFFFFFF..........E..WWWWWWWWWWW
WWWWWWW......EFFFFFFF..........FFFFFFF........E......WWWWWWW
WWWWWWW......EFFFFF............MMFFFFMMY......E......WWWWWWW
WWWWWWW..EEEEEFFF.....1...1...FMMFFFFMMY......EEEEE..WWWWWWW
WWWWWWW..E...YFFF.............FXX...FMMY......Y...E..WWWWWWW
WWWWWWW..E...YFF..1...........FX......XY......Y...E..WWWWWWW
WWWWWWW..E...Y......YXMMMX....FF......XY......Y.7.E..WWWWWWW
WWWWWWW..E.6........YXC.......FF..................E..WWWWWWW
WWWWWWW..E.................................2....7.E..WWWWWWW
WWWWWWW..E.6....1.....................MIF.........E..WWWWWWW
WWWWWWW..E...Y.....FFF..............MMMIF.....Y.7.E..WWWWWWW
WWWWWWW..E.6.Y.....FIMMM..............FFF.....Y...E..WWWWWWW
WWWWWWW..E.........FIM.....................2....7.E..WWWWWWW
WWWWWWW..E.6....1.................................E..WWWWWWW
WWWWWWW..E..................FF.......CXY........7.E..WWWWWWW
WWWWWWW..E.6.Y......YX......FF....XMMMXY......Y...E..WWWWWWW
WWWWWWW..E...Y......YM......XF...........2..FFY...E..WWWWWWW
WWWWWWW..E...Y......YMMF...XXF.............FFFY...E..WWWWWWW
WWWWWWW..EEEEE......YMMFFFFMMF...2...2.....FFFEEEEE..WWWWWWW
WWWWWWW......E......YMMFFFFMM............FFFFFE......WWWWWWW
WWWWWWW......E........FFFFFFF..........FFFFFFFE......WWWWWWW
WWWWWWWWWWW..E..........FFFFFFFF.......FFFFFFFE..WWWWWWWWWWW
WWWWWWWWWWW..EFF........FFFFFFFFFFFF...FFFMM..E..WWWWWWWWWWW
WWWWWWWWWWW..EFFFF..........FFFFFFFF..........E..WWWWWWWWWWW
WWWWWWWWWWW..EFFFFMMM.........MMMMMMM.........E..WWWWWWWWWWW
WWWWWWWWWWW..EFFFFMMMXXX......MMMMMMMXXX......E..WWWWWWWWWWW
WWWWWWWWWWW..EEEEEEEEEEEEEEEEEEEEEEEEEEEEEEEEEE..WWWWWWWWWWW
WWWWWWWWWWW......................................WWWWWWWWWWW
WWWWWWWWWWW......................................WWWWWWWWWWW
WWWWWWWWWWWWWWWWWWWWWWWWWWWWWWWWWWWWWWWWWWWWWWWWWWWWWWWWWWWW
WWWWWWWWWWWWWWWWWWWWWWWWWWWWWWWWWWWWWWWWWWWWWWWWWWWWWWWWWWWW
WWWWWWWWWWWWWWWWWWWWWWWWWWWWWWWWWWWWWWWWWWWWWWWWWWWWWWWWWWWW
WWWWWWWWWWWWWWWWWWWWWWWWWWWWWWWWWWWWWWWWWWWWWWWWWWWWWWWWWWWW
WWWWWWWWWWWWWWWWWWWWWWWWWWWWWWWWWWWWWWWWWWWWWWWWWWWWWWWWWWWW
WWWWWWWWWWWWWWWWWWWWWWWWWWWWWWWWWWWWWWWWWWWWWWWWWWWWWWWWWWWW
WWWWWWWWWWWWWWWWWWWWWWWWWWWWWWWWWWWWWWWWWWWWWWWWWWWWWWWWWWWW
WWWWWWWWWWWWWWWWWWWWWWWWWWWWWWWWWWWWWWWWWWWWWWWWWWWWWWWWWWWW
WWWWWWWWWWWWWWWWWWWWWWWWWWWWWWWWWWWWWWWWWWWWWWWWWWWWWWWWWWWW
WWWWWWWWWWWWWWWWWWWWWWWWWWWWWWWWWWWWWWWWWWWWWWWWWWWWWWWWWWWW
WWWWWWWWWWWWWWWWWWWWWWWWWWWWWWWWWWWWWWWWWWWWWWWWWWWWWWWWWWWW
WWWWWWWWWWWWWWWWWWWWWWWWWWWWWWWWWWWWWWWWWWWWWWWWWWWWWWWWWWWW