WWWWWWWWWWWWWWWWWWWWWWWWWWWWWWWWWWWWWWWWWWWWWWWWWWWWWWWWWWWW
WWWWWWWWWWWWWWWWWWWWWWWWWWWWWWWWWWWWWWWWWWWWWWWWWWWWWWWWWWWW
WWWWWWWWWWWWWWWWWWWWWWWWWWWWWWWWWWWWWWWWWWWWWWWWWWWWWWWWWWWW
WWWWWWWWWWWWWWWWWWWWWWWWWWWWWWWWWWWWWWWWWWWWWWWWWWWWWWWWWWWW
WWWWWWWWWWWWWWWWWWWWWWWWWWWWWWWWWWWWWWWWWWWWWWWWWWWWWWWWWWWW
WWWWWWWWWWWWWWWWWÊWWWWWWWWWWWWWWWWWWWWWWWWWWWWWWWWWWWWWWWWWW
WWWWWWWWWWWWWWWWWWWWWWWWWWWWWWWWÊWWWWWWWWWWWWWWWWWWWWWWWWWWW
WWWWWWWWWWWWWWWWWWWWWWWWWWWWWWWWWWWWWWWWWWWWWWWWWWWWWWWWWWWW
WWWWWWWWWWWWWWWWWWWWWWWWWWWWWWWWWWWWWWÊWWWWWWWWWWWWWWWWWWWWW
WWWWWWWWWWWWWWWWWWWWWWWWWWWWWWWWWWWWWWWWWWWWWWWWWWWWWWWWWWWW
WWWWWWWWÉWWWWEEEEEEEEEEEEEEEEWWWWWWWWWWWWWWWWWWWWWWWWWWWWWWW
WWWWWWWWWWWWWEYY.FF...FF.BMMEWWWWWWWWWWWWWWWWWWWWWWWWWWWWWWW
WWWWWWWWWWWWWEY..FF...FF..XMEEEEEEEEEEEEEEEEEWWWWWWWWWWWWWWW
WWWWWWWWWWXÈWEC.FFF...FFF.................MMEWXXWWWWWWWWWWWW
WWWWWWWWWWXXWEC.................2.2.2.2.2.XMEWÈXWWWWÊWWWWWWW
WWWWWWWWWWWWWE....NNNN.......F............XMEWWWWWWWWWWWWWWW
WWWWWFFFWWWEEE.....D.....XXX.F............MMEEEWWWWWWWWWWWWW
WWWWWFTFWWWE.............DM..F............NNNNEWWWWWWWWWWWWW
WWWWWFFWWWWE.D....MMT.....M.FF................EWXXWWWWWWWWWW
WWWWWFFWXXWEFFFFF........MM.FF.....D..........EWXXWWWWWWWWWW
WWWWWÈFWXXWEFFFFF.FF........FF.T.F.MX.........EWWWWFFWWWWWWW
WWWWWWWWWWWEFF....FF.FFFFFFFFF...F.MXT.FFFFFF.EWWFÈFFWWWWWWW
WWWWWWWWWWWE...XX....FFFFFFFFF..FF.MMM.FFFFFF.EWWFFFFWWWWWWW
WWWWWWWWWWWE...MMMMM.FF..D.FFWWFFF.D.......FF.EWWWWWWWWWWWWW
WWWWWWWWXXWE....D.TM....MM..FWWFFFFFFFF.MM....EWXXWWWWWWWWWW
WWWWWWWWÈXWED...........XXT.FWWFFFFFFFF.......EWXXWWWWWWWWWW
WWWWWWWWWWWE.................WWFF....FF....D..EWWWWWWWWWWWWW
WWWWWWWWWWWENNNN...............FF.TMD.....NNNNEWWWWÉWWWWWWWW
WWWWWWWWWWWEEEEN...8...........F.DXM........NEEWWWWWWWWWWWWW
WWWWWWÊWWWWWÈXEN........WWWWF..FWWWW........NETXWWWWWWWWWWWW
WWWWWWWWWWWWXTEN........WWWWF..FWWWW...8....NEXÈWWWWWÊWWWWWW
WWWWWWWWWWWWWEEN........MXD.F...............NEEEEWWWWWWWWWWW
WWWWWWWWÉWWWWENNNN.....DMT.FF...............NNNNEWWWWWWWWWWW
WWWWWWWWWWWWWE..D....FF....FFWW.................EWWWWWWWWWWW
WWWWWWWWWWXXWE.......FFFFFFFFWWF.TXX...........DEWXÈWWWWWWWW
WWWWWWWWWWXXWE....MM.FFFFFFFFWWF..MM....MT.D....EWXXWWWWWWWW
WWWWWWWWWWWWWE.FF.......D.FFFWWFF.D..FF.MMMMM...EWWWWWWWWWWW
WWWWWWWFFFFWWE.FFFFFF.MMM.FF..FFFFFFFFF....XX...EWWWWWWWWWWW
WWWWWWWFFÈFWWE.FFFFFF.TXM.F...FFFFFFFFF.FF....FFEWWWWWWWWWWW
WWWWWWWFFWWWWE.........XM.F.T.FF........FF.FFFFFEWXXWFÈWWWWW
WWWWWWWWWWXXWE..........D.....FF.MM........FFFFFEWXXWFFWWWWW
WWWWWWWWWWXXWE................FF.M.....TMM....D.EWWWWFFWWWWW
WWWWWWWWWWWWWENNNN............F..MD.............EWWWFTFWWWWW
WWWWWWWWWWWWWEEEMM............F.XXX.....D.....EEEWWWFFFWWWWW
WWWWWWWWWWWWWWWEMX............F.......NNNN....EWWWWWWWWWWWWW
WWWWWWWÊWWWWXÈWEMX.1.1.1.1.1.................CEWXXWWWWWWWWWW
WWWWWWWWWWWWXXWEMM.................FFF...FFF.CEWÈXWWWWWWWWWW
WWWWWWWWWWWWWWWEEEEEEEEEEEEEEEEEMX..FF...FF..YEWWWWWWWWWWWWW
WWWWWWWWWWWWWWWWWWWWWWWWWWWWWWWEMMB.FF...FF.YYEWWWWWWWWWWWWW
WWWWWWWWWWWWWWWWWWWWWWWWWWWWWWWEEEEEEEEEEEEEEEEWWWWÉWWWWWWWW
WWWWWWWWWWWWWWWWWWWWWWWWWWWWWWWWWWWWWWWWWWWWWWWWWWWWWWWWWWWW
WWWWWWWWWWWWWWWWWWWWWÊWWWWWWWWWWWWWWWWWWWWWWWWWWWWWWWWWWWWWW
WWWWWWWWWWWWWWWWWWWWWWWWWWWWWWWWWWWWWWWWWWWWWWWWWWWWWWWWWWWW
WWWWWWWWWWWWWWWWWWWWWWWWWWWÊWWWWWWWWWWWWWWWWWWWWWWWWWWWWWWWW
WWWWWWWWWWWWWWWWWWWWWWWWWWWWWWWWWWWWWWWWWWÊWWWWWWWWWWWWWWWWW
WWWWWWWWWWWWWWWWWWWWWWWWWWWWWWWWWWWWWWWWWWWWWWWWWWWWWWWWWWWW
WWWWWWWWWWWWWWWWWWWWWWWWWWWWWWWWWWWWWWWWWWWWWWWWWWWWWWWWWWWW
WWWWWWWWWWWWWWWWWWWWWWWWWWWWWWWWWWWWWWWWWWWWWWWWWWWWWWWWWWWW
WWWWWWWWWWWWWWWWWWWWWWWWWWWWWWWWWWWWWWWWWWWWWWWWWWWWWWWWWWWW
WWWWWWWWWWWWWWWWWWWWWWWWWWWWWWWWWWWWWWWWWWWWWWWWWWWWWWWWWWWW