WWWWWWWWWWWWWWWWWWWWWWWWWWWWWWWWWWWWWWWWWWWWWWWWWWWWWWWWWWWW
WWWWWWWWWWWWWWWWWWWWWWWWWWWWWWWWWWWWWWWWWWWWWWWWWWWWWWWWWWWW
WWWWWWWWWWWWWWWWWWWWWWWWWWWWWWWWWWWWWWWWWWWWWWWWWWWWWWWWWWWW
WWWWWWWWWWWWWWWWWWWWWWWWWWWWWWWWWWWWWWWWWWWWWWWWWWWWWWWWWWWW
WWWWWWWWWWWWWWWWWWWWWWWWWWWWWWWWWWWWWWWWWWWWWWWWWWWWWWWWWWWW
WWWWWWWWWWWWWWWW.FMMFWWWWWWWWWWWWWWWWWWWWWWWWWWWWWWWWWWWWWWW
WWWWWWWWWWWWWWWM»..»MFWWWWWWWWWWWWWWMMWWWWWWWWWWWWWWWWWWWWWW
WWWWWWWWWWWWWWWFX»XXFFWWWWWWWWWWWWWM»XXWWWWWWWWWWWWWWWWWWWWW
WWWWWWWWWWWWWWWWMFMMFWWWWWWWWWWWWWWMFXMWWWWWWWWWWWWWWWWWWWWW
WWWWWWFFWWWWWWWWWWWWWWWWWWWWWWWWWWWWFFWWWWWWWWWWWWWWWWWWWWWW
WWWWWWM…FWWWWWWWWWWWWWWMF…FFF…FFMWWWWWWWWWWWWWWWWWFFWWWWWWWW
WWWWWWWFMWWWWWWWWWWWMFMMFFMMFFMMFFMWWWWWWWWWWWWWWF…MWWWWWWWW
WWWWWWWWWWWWWXFEEEEEEEEEEEEEEEEEEEEEEEEEEEEEEMXWWMFWWWWWWWWW
WWWWWWWWWWWWFFXEXMTDDD.D.............XXMXMXMEX.FWWWWWWWWWWWW
WWWWWWWWWWWDD.XEMXXDD.....2.2.2.2.2..XXXMMMXEM».FWWWWWWWWWWW
WWWWWWWWWWWFX»MEXMXD.................FFFFXMXEXF»DWWWWWWWWWWW
WWWWWWWWWWWM.XMEMXXX....XXMXFFFFF....FFFFXXMEF.XFWWWWWWWWWWW
WWWWWWWWWWWM»FXEXMMXX...XXMMFFFFF....IIFFXXMEX»MMWWWWWWWWWWW
WWWWWWWWWWWF..XEMXXXX....XXMFFXMX....I...BXXEX.MDWWWWWWWWWWW
WWWWWWWWWWWFX»FEXXXII.....XXFFMXX....T....XXEM».FWWWWWWWWWWW
WWWWWWWFMWWDFXFEMXB........XFFTT..........XMEXF»FWWWWWWWWWWW
WWWWWWF..FWM»FXEXX.............D..........XXEF».XWWWWWWWWWWW
WWWWWM»….FWFX.MEXM........................XIEXMXMWWWWWWWWWWW
WWWWM.»MFWWXF»FEXX.....I.........FFFXM....IIEEEEEWMMWWWWWWWW
WWWWF».FWWWFMMXEIX...DII....D....FFFIXX....BXXMXEWFF»FWWWWWW
WWWWWFFWWWWEEEEEII...XXX...IITTXXFFFIIT......XXMEWWMFMWWWWWW
WWWWWWWWWWWEMMXXB...................D.........XXEWWW»FWWWWWW
WWWWWWWWWWWEMXX................................XEWWWMFWWWWWW
WWWWWWWWWWWEXX..................................EWWWWWWWWWWW
WWWWWWWFFMWEX....FFFTXMX.....8......XXXTFFF...D.EWWWWWWWWWWW
WWWWWWWM»FWE.D...FFFTXXX............XMXTFFF....XEWWWWWWWWWWW
WWWWWWWFFWWE..................................XMEWWWWFFWWWWW
WWWWWWWWWWWEX.............................DD.XMXEWWWM».FWWWW
WWWWWWWWWWWEMX.........D..................DBXXXMEWWMFF»MWWWW
WWWWWWWWWWWEMMX......TIIFFFXXTTII...XXX...IIEEEEEWF.».FWWWWW
WWWWWWWWWWWEXMXXB....XXIFFF....D....IID...XIEXTXXWM….FWWWWWW
WWWWWWWWWWWEEEEEII....MXFFF.........I.....XXEF»FFWWFFWWWWWWW
WWWWWWWWWWWMX»XEIX........................XMEX.»FWWWWWWWWWWW
WWWWWWWWWWWFFXMEXX..........D.............XXEM»FDWWWWWWWWWWW
WWWWWWMMWWWF»FXEMX..........TTFFX........BXMEF.XFWWWWWWWWWWW
WWWWWWFMMWWDFXFEXX....T....XXXFFXX.....IIXXMEX»FFWWWWWWWWWWW
WWWWWWF»FWWMX»MEXXB...I....XMXFFMMX....XXMMXEMX.MWWWWWWWWWWW
WWWWWWWMFWWMF.XEMXXFFII....FFFFFXXMX...XXMXMEX.»MWWWWWWWWWWW
WWWWWWWWWWWF.»XEMXXFFFF....FFFFFXMXX....XXMXE.».FWWWWWWWWWWW
WWWWWWWWWWWD»XXEXXXFFFF.................DXMMEX.XDWWWFWWWWWWW
WWWWWWWWWWWFX.MEMXMXXXX..1.1D1.1.1.....DDXXXEM»FMWWF…FWWWWWW
WWWWWWWWWWWWF»XEMMXMXMXBD............DDDDTXXEX.FWWWWFWWWWWWW
WWWWWWWWWWWWWDFEEEEEEEEEEEEEEEEEEEEEEEEEEEEEEFXWWWWWWWWWWWWW
WWWWWWWWWWWWWWWWWWWWWWMMFFFMMMFMFFFMMWWWWWWWWWWWWWWWWWWWWWWW
WWWWWWWWWWFFWWWWWWWWWWWWWMFF…FF…FMWWWWWWWWWWWWWWWWWWWWWWWWWW
WWWWWWWWWWF…FWWWWWWFMWWWWWWWWWWWWWWWWWFFXFMWWWWWWWWWWWWWWWWW
WWWWWWWWWWWFFWWWWWMXXMWWWWWWWWWWWWWWWM»X.».FWWWWWWWWWWWWWWWW
WWWWWWWWWWWWWWWWWWFX»FWWWWWWWWWWWWWWWMX»XXMFWWWWWWWWWWWWWWWW
WWWWWWWWWWWWWWWWWWWMFWWWWWWWWWWWWWWWWWF.MMFWWWWWWWWWWWWWWWWW
WWWWWWWWWWWWWWWWWWWWWWWWWWWWWWWWWWWWWWWWWWWWWWWWWWWWWWWWWWWW
WWWWWWWWWWWWWWWWWWWWWWWWWWWWWWWWWWWWWWWWWWWWWWWWWWWWWWWWWWWW
WWWWWWWWWWWWWWWWWWWWWWWWWWWWWWWWWWWWWWWWWWWWWWWWWWWWWWWWWWWW
WWWWWWWWWWWWWWWWWWWWWWWWWWWWWWWWWWWWWWWWWWWWWWWWWWWWWWWWWWWW
WWWWWWWWWWWWWWWWWWWWWWWWWWWWWWWWWWWWWWWWWWWWWWWWWWWWWWWWWWWW
WWWWWWWWWWWWWWWWWWWWWWWWWWWWWWWWWWWWWWWWWWWWWWWWWWWWWWWWWWWW