WWWWWWWWWWWWWWWWWWWWWWWWWWWWWWWWWWWWWWWWWWWWWWWWWWWWWWWWWWWW
WWWWWWWWWWWWWWWWWWWWWWWWWWWWWWWWWWWWWWWWWWWWWWWWWWWWWWWWWWWW
WWWWWWWWWWWWWWWWWWWWWWWWWWWWWWWWWWWWWWWWWWWWWWWWWWWWWWWWWWWW
WWWWWWWWWWWWWWWWWWWWWWWWWWWWWWWWWWWWWWWWWWWWWWWWWWWWWWWWWWWW
WWWWWWWWWWWWWWWWWWWWWWWWWWWWWWWWWWWWWWWWWWWWWWWWWWWWWWWWWWWW
WWWWWWWWWWWWWWWWWWWWWWWWWWWWWWWWWWWWWWWWWWWWWWWWWWWWWWWWWWWW
WWWWWWWWWWWWWWWWWWWWWWWWWWWWWWWWWWWWWWWWWWWWWWWWWWWWWWWWWWWW
WWWWWWWWWWWWWWWWWWWWWWWWWWWWWWWWWWWWWWWWWWWWWWWWWWWWWWWWWWWW
WWWWWWWWWWWWWWWWWWWWWWWWWWWWWWWWWWWWWWWWWWWWWWWWWWWWWWWWWWWW
WWWWWWWWWWWWWWWWWWWWWWWWWWWWWWWWWWWWWWWWWWWWWWWWWWWWWWWWWWWW
WWWWWWWWWWWWWWWWWWWWWWWWWWWWWWWWWWF…FFF…FFFWWWWWWWWWWWWWWWWW
WWWWWWWWWWWWWWWWWWWWWWWWWWWWWWWWWFMMFFMFFMMFWWWWWWWWWWWWWWWW
WWWWWWWWWWWWWWWEEEEEEEEEEEEEEEEEEEEEEEEEEEEEEWWWWWWWWWWWWWWW
WWWWWWWWWWWWWWFEBBBCC.DD.........D....DXXMMMEFWWWWWWWWWWWWWW
WWWWWWWWWWWWWFMEBB........2.2.2.2.2.....XXMMEM»WWWWWWWWWWWWW
WWWWWWWWWWWWWFFEB........................XXMEFFMWWWWWWWWWWWW
WWWWWWWWWWWWF»FE................DNNNNN....XXEM»FWWWWWWWWWWWW
WWWWWWWWWWWWM.ME...NNNN.......DDFFFFF......XEF.FWWWWWWWWWWWW
WWWWWWWWWWWWF»ME...FFFN....D.DDDFFFFF.......EF……WWWWWWWWWWWW
WWWWWWWWWWWW…»FED..........NNNNNFF.........DEM»FWWWWWWWWWWWW
WWWWWWWWWWWWF.FET...........TTTNFF.........DEMFWWWWWWWWWWWWW
WWWWWWWWWWWWF…FET.....................III...EFWWWWWWWWWWWWWW
WWWWWWWWWWWWMFFE......................XXX...EWWWWWWWWWWWWWWW
WWWWWWWWWWWWF»FE...I....XFFF...............DEWWFFWWWWWWWWWWW
WWWWWWWWWWWWFFMEFFII....XXXX.....NNN.......FEWF»…FWWWWWWWWWW
WWWWWWWWWWWW…»FEFF.................NB.....FFEW…FFFWWWWWWWWWW
WWWWWWWWWWWWFFMEFF.................NBB....TTEWFF…FWWWWWWWWWW
WWWWWWWWWWWWF»FEFF...8......WWWW...NBBB.....EWF»FFWWWWWWWWWW
WWWWWWWWWWWWWFMEFF.........WWWWWW..NNNNN....EWM.FMWWWWWWWWWW
WWWWWWWWWWWWWWMEFF.........WWWWWW...D.....FFEWWFFWWWWWWWWWWW
WWWWWWWWWWWFFWWEFF..DD..D..WWWWWW.........FFEWWWWWWWWWWWWWWW
WWWWWWWWWW….»FWE....NNNNN..WWWWWW....8....FFEFWWWWWWWWWWWWWW
WWWWWWWWWWFF.FWE.....BBBN...WWWW..........FFEMFWWWWWWWWWWWWW
WWWWWWWWWW..…FWETT....BBN.................FFEF»FWWWWWWWWWWWW
WWWWWWWWWW….»MWEFF.....BN.................FFEMFMWWWWWWWWWWWW
WWWWWWWWWWFF.FWEF.......NNN.....XXXX....IIFFEF»FWWWWWWWWWWWW
WWWWWWWWWWWFFWWE................FFFX....I...EFF…WWWWWWWWWWWW
WWWWWWWWWWWWWWWED..XXX...................D..EF»FWWWWWWWWWWWW
WWWWWWWWWWWWWWFE...III.....................TEF.FWWWWWWWWWWWW
WWWWWWWWWWWWW»ME..........FFNTTT...........TEF…FWWWWWWWWWWWW
WWWWWWWWWWWWMFME..........FFNNNNN..........DEFFFWWWWWWWWWWWW
WWWWWWWWWWWWF»FED......FFFFFD........NFFF..DEF»…WWWWWWWWWWWW
WWWWWWWWWWWWF.FEX......FFFFF.........NNNN...EMFFWWWWWWWWWWWW
WWWWWWWWWWWWF…FEXX....NNNNN.................EF»FWWWWWWWWWWWW
WWWWWWWWWWWWF»MEMXX........................BEFFMWWWWWWWWWWWW
WWWWWWWWWWWWWFFEMMXX.....1.1.1.1.1........BBEMFWWWWWWWWWWWWW
WWWWWWWWWWWWWWFEMMMXX.D............D.DDCCBBBEMWWWWWWWWWWWWWW
WWWWWWWWWWWWWWWEEEEEEEEEEEEEEEEEEEEEEEEEEEEEEWWWWWWWWWWWWWWW
WWWWWWWWWWWWWWWWWFMFFFF.MMFFWWWWWWWWWWWWWWWWWWWWWWWWWWWWWWWW
WWWWWWWWWWWWWWWWWWFF….F….FFWWWWWWWWWWWWWWWWWWWWWWWWWWWWWWWWW
WWWWWWWWWWWWWWWWWWWWWWWWWWWWWWWWWWWWWWWWWWWWWWWWWWWWWWWWWWWW
WWWWWWWWWWWWWWWWWWWWWWWWWWWWWWWWWWWWWWWWWWWWWWWWWWWWWWWWWWWW
WWWWWWWWWWWWWWWWWWWWWWWWWWWWWWWWWWWWWWWWWWWWWWWWWWWWWWWWWWWW
WWWWWWWWWWWWWWWWWWWWWWWWWWWWWWWWWWWWWWWWWWWWWWWWWWWWWWWWWWWW
WWWWWWWWWWWWWWWWWWWWWWWWWWWWWWWWWWWWWWWWWWWWWWWWWWWWWWWWWWWW
WWWWWWWWWWWWWWWWWWWWWWWWWWWWWWWWWWWWWWWWWWWWWWWWWWWWWWWWWWWW
WWWWWWWWWWWWWWWWWWWWWWWWWWWWWWWWWWWWWWWWWWWWWWWWWWWWWWWWWWWW
WWWWWWWWWWWWWWWWWWWWWWWWWWWWWWWWWWWWWWWWWWWWWWWWWWWWWWWWWWWW
WWWWWWWWWWWWWWWWWWWWWWWWWWWWWWWWWWWWWWWWWWWWWWWWWWWWWWWWWWWW
WWWWWWWWWWWWWWWWWWWWWWWWWWWWWWWWWWWWWWWWWWWWWWWWWWWWWWWWWWWW