WWWWWWWWWWWWWWWWWWWWWWWWWWWWWWWWWWWWWWWWWWWWWWWWWWWWWWWWWWWW
WWWWWWWWWWWWWWWWWWWWWWWWWWWWWWWWWWWWWWWWWWWWWWWWWWWWWWWWWWWW
WWWWWWWWWWWWWWWWWWWWWWWWWWWWWWWWWWWWWWWWWWWWWWWWWWWWWWWWWWWW
WWWWWWWWWWWWWWWWWWWWWWWWWWWWWWWWWWWWWWWWWWWWWWWWWWWWWWWWWWWW
WWWWWWWWWWWWWWWWWWWWWWWWWWWWWWWWWWWWWWWWWWWWWWWWWWWWWWWWWWWW
WWWWWWWWWWWWWWWWWWWWWWWWWWWWWWWWWWWWWWWWWWWWWWWWWWWWWWWWWWWW
WWWWWWWWWWWWWWWWWWWWWWWWWWWWWWWWWWWWWWWWWWWWWWWWWWWWWWWWWWWW
WWWWWWWWWWWWWWWWWWWWWWWWWWWWWWWWWWWWWWWWWWWWWWWWWWWWWWWWWWWW
WWWWWWWWWWWWWWWWWWWWWWWWWWWWWWWWWWWWWWWWWWWWWWWWWWWWWWWWWWWW
WWWWWWWWWWWWWWWWWWWWWWWWWWWWWWWWWWWWWWWWWWWWWWWWWWWWWWWWWWWW
WWWWWWWWWWWWWWWWWWWWWWWWWWWWWWWWWWWWWWWWWWWWWWWWWWWWWWWWWWWW
WWWWWWWWWWWWWWWWWWWWWWWWWWWWWWWWWWWWWWWWWWWWWWWWWWWWWWWWWWWW
WWWWWWWWWWWWWWWEEEEEEEEEEEEEEEEEEEEEEEEEEEEEEWWWWWWWWWWWWWWW
WWWWWWWWWWWWWWWEMMXXXX.DD...........D.XXXXMMEWWWWWWWWWWWWWWW
WWWWWWWWWWWWWWWEMXXXXD....2.2.2.2.2...DXXXXMEWWWWWWWWWWWWWWW
WWWWWWWWWWWWWW.EXXXX....................XXXXE.WWWWWWWWWWWWWW
WWWWWWWWWWWWWD.EXXX..........FF....BB....XXXE.DWWWWWWWWWWWWW
WWWWWWWWWWWW...E..........F.FFFF.F..........E...WWWWWWWWWWWW
WWWWWWWWWWWW...ED......N...FF..FF........F.FE.F.WWWWWWWWWWWW
WWWWWWWWWWW.D..EB......N..FF.MM.FF.C....F.FFEF.F.WWWWWWWWWWW
WWWWWWWWWWW....EB.....TN..FF.MM.FF.N.....FFDEFF..WWWWWWWWWWW
WWWWWWWWWWW..F.E....NNNN...FF..FF..N.....FDYE.F.DWWWWWWWWWWW
WWWWWWWWWWWFF.FED....BB...F.FFFF.F.N.....FFDEFF..WWWWWWWWWWW
WWWWWWWWWWW.FF.EX.....F...D..FF....NNNN.F.FFEF.F.WWWWWWWWWWW
WWWWWWWWWWW.FFFEXX.FF..F............BBD..F.FE.F..WWWWWWWWWWW
WWWWWWWWWWWF..FED...FFFF.F.....DD.........D.E....WWWWWWWWWWW
WWWWWWWWWWWF..FE..FFF..FFFD..IIII.......IIIIE....WWWWWWWWWWW
WWWWWWWWWWW.FFFE.F.F.8..F...BIIXX...........E....WWWWWWWWWWW
WWWWWWWWWWW.FF.EB..F....F.FDBXXX...F....F...ED...WWWWWWWWWWW
WWWWWWWWWWWFF.FEB.FFF..FFF..DXX.....FFFF....E...DWWWWWWWWWWW
WWWWWWWWWWW..F.E..F.FFFF.....XX..F.FF..FF.FBE....WWWWWWWWWWW
WWWWWWWWWWW....E....F..FF...XXXB.DFF.8..FF.BE..F.WWWWWWWWWWW
WWWWWWWWWWW.D..E...D.F.....XXIIBDDFF....FF..E.F.FWWWWWWWWWWW
WWWWWWWWWWW....EIIII.......IIII.DF.FF..FF.F.E..FFWWWWWWWWWWW
WWWWWWWWWWW....ED.D........D..D.....FFFF...DE.FF.WWWWWWWWWWW
WWWWWWWWWWW..F.EF.F...BB...........F....F.XXE.FF.WWWWWWWWWWW
WWWWWWWWWWW...FEFF...NNNN..F.FF.F..........XE.FF.WWWWWWWWWWW
WWWWWWWWWWW..FFEDFF.....N.F.FFFF.F...BB...DDE..FFWWWWWWWWWWW
WWWWWWWWWWW..F.EXDF.....N..FF..FF...NNNN...DE.F.FWWWWWWWWWWW
WWWWWWWWWWW..FFEDFF.....N.FF.MM.FF..NX.....BE..F.WWWWWWWWWWW
WWWWWWWWWWW...FEFF......C.FF.MM.FF..N......BE....WWWWWWWWWWW
WWWWWWWWWWWW.F.EF.F........FF..FF...N......DE...WWWWWWWWWWWW
WWWWWWWWWWWW...E..........F.FFFF.F..........E.D.WWWWWWWWWWWW
WWWWWWWWWWWWWD.EXXX....BB..F.FF.F........XXXE..WWWWWWWWWWWWW
WWWWWWWWWWWWWW.EXXXX....................XXXXE.WWWWWWWWWWWWWW
WWWWWWWWWWWWWWWEMXXXXD...1.1.1.1.1.....XXXXMEWWWWWWWWWWWWWWW
WWWWWWWWWWWWWWWEMMXXXX.D............D.XXXXMMEWWWWWWWWWWWWWWW
WWWWWWWWWWWWWWWEEEEEEEEEEEEEEEEEEEEEEEEEEEEEEWWWWWWWWWWWWWWW
WWWWWWWWWWWWWWWWWWWWWWWWWWWWWWWWWWWWWWWWWWWWWWWWWWWWWWWWWWWW
WWWWWWWWWWWWWWWWWWWWWWWWWWWWWWWWWWWWWWWWWWWWWWWWWWWWWWWWWWWW
WWWWWWWWWWWWWWWWWWWWWWWWWWWWWWWWWWWWWWWWWWWWWWWWWWWWWWWWWWWW
WWWWWWWWWWWWWWWWWWWWWWWWWWWWWWWWWWWWWWWWWWWWWWWWWWWWWWWWWWWW
WWWWWWWWWWWWWWWWWWWWWWWWWWWWWWWWWWWWWWWWWWWWWWWWWWWWWWWWWWWW
WWWWWWWWWWWWWWWWWWWWWWWWWWWWWWWWWWWWWWWWWWWWWWWWWWWWWWWWWWWW
WWWWWWWWWWWWWWWWWWWWWWWWWWWWWWWWWWWWWWWWWWWWWWWWWWWWWWWWWWWW
WWWWWWWWWWWWWWWWWWWWWWWWWWWWWWWWWWWWWWWWWWWWWWWWWWWWWWWWWWWW
WWWWWWWWWWWWWWWWWWWWWWWWWWWWWWWWWWWWWWWWWWWWWWWWWWWWWWWWWWWW
WWWWWWWWWWWWWWWWWWWWWWWWWWWWWWWWWWWWWWWWWWWWWWWWWWWWWWWWWWWW
WWWWWWWWWWWWWWWWWWWWWWWWWWWWWWWWWWWWWWWWWWWWWWWWWWWWWWWWWWWW
WWWWWWWWWWWWWWWWWWWWWWWWWWWWWWWWWWWWWWWWWWWWWWWWWWWWWWWWWWWW