WWWWWWWWWWWWWWWWWWWWWWWWWWWWWWWWWWWWWWWWWWWWWWWWWWWWWWWWWWWW
WWWWWWWWWWWWWWWWWWWWWWWWWWWWWWWWWWWWWWWWWWWWWWWWWWWWWWWWWWWW
WWWWWWWWWWWWWWWWWWWWWWWWWWWWWWWWWWWWWWWWWWWWWWWWWWWWWWWWWWWW
WWWWWWWWWWWWWWWWWWWWWWWWWWWWWWWWWWWWWWWWWWWWWWWWWWWWWWWWWWWW
WWWWWWWWWWWWWWWWWWWWWWWWWWWWWWWWWWWWWWWWWWWWWWWWWWWWWWWWWWWW
WWWWWWWWWWWWWWWWWWWWWWWWWWWWWWWWWWWWWWWWWWWWWWWWWWWWWWWWWWWW
WWWWWWWWWWWWWWWWWWWWWWWWWWWWWWWWWWWWWWWWWWWWWWWWWWWWWWWWWWWW
WWWWWWWWWWWWWWWWWWWWWWWWWWWWWWWWWWWWWWWWWWWWWWWWWWWWWWWWWWWW
WWWWWWWWWWWWWWWWWWWWWWWWWWWWWWWWWWWWWWWWWWWWWWWWWWWWWWWWWWWW
WWWWWWWWWWWWWWÊWWWWWWW...F...FM..FFF..WWWWWWWÊWWWWWWWWWWWWWW
WWWWWWWWWWWWWWWWWWWD.F.É..É.....É...É..FFWWWWWWWWWWWWWWWWWWW
WWWWWWWWWWWWWWWWWDFMFFFM.F.FFMFFFF.F..FFFFFWWWWWWWWWWWWWWWWW
WWWWWWWWWWWWWWWEEEEEEEEEEEEEEEEEEEEEEEEEEEEEEWWWÊWWWWWWWWWWW
WWWWWWWWWWWÊWWDEDD.CCDD.D............D.FFFFCEFWWWWWWWWWWWWWW
WWWWWWWWWWWWWWFED.........2.2.2.2.2.....FFFFEFWWWWWWWWWWWWWW
WWWWWWWWWWWWWFFE.........................FFFEFFWWWWWWWWWWWWW
WWWWWWWWWWWWW.ME..........................DFEFFWWWWWWWWWWWWW
WWWWWWWWWWWWWFDE...NNNN......NFFFFFFFF.....DEF.WWWWWWWWWWWWW
WWWWWWWWWWWW...EDDD.D.T......NNNNNFFF...BM.DE.DMWWWWWWWWWWWW
WWWWWWWWWWWWFÉ.EDDD...........TTTNFF....MM..EF.DWWWWWWWWWWWW
WWWWWWWWWWWW...EBD...............NF.........E.É.WWWWWWWWWWWW
WWWWWWWWWWWWD.FEX...........................E...WWWWWWWWWWWW
WWWWWWWWWWWM.FFEFFD........................DEMF.DWWWWWWWWWWW
WWWWWWWWWWWF.FFEFFF..IBBBN.DD.........XXX...EF...WWWWWWWWWWW
WWWWWWWWÊWW.FFFEFFFIIIFFFNNNNNN............FEF.É.WWWWWWWWWWW
WWWWWWWWWWWDFFFEFFFFFFFFFFFF..NBBBB.......FFEF.F.WWWWWWWWWWW
WWWWWWWWWWWFFFFEFFFFFFFFFFF.......BII.....MMEF..FWWWWWWWWWWW
WWWWWWWWWWW..FFEF..................IFD.....DE.É.MWWWWWWWWWWW
WWWWWWWWWWWM.DFE...................IFF......EF..DWWWWWWWWWWW
WWWWWWWWWWW....EDD..D........8.............DE...FWWWWWWWWWWW
WWWWWWWWWWWD.É.ED...........................EM.É.WWWWWWWWWWW
WWWWWWWWWWW.F.FE......FFI...................EF...WWWWWWWWWWW
WWWWWWWWWWWF..MED.....DFI..................FEFF.FWWWÊWWWWWWW
WWWWWWWWWWW.É.DEMM.....IIB.......FFFFFFFFFFFEFFF.WWWWWWWWWWW
WWWWWWWWWWWD..FEFF.......BBBBN..FFFFFFFFFFFFEFFF.WWWWWWWWWWW
WWWWWWWWWWW....EF............NNNNNNFFFIIIFFFEFFF.WWWWWWWWWWW
WWWWWWWWWWWM.É.E...XXX.........DD.NBBBID.FFFEFF.MWWWWWWWWWWW
WWWWWWWWWWWWD.FED........................DFFEFF.WWWWWWWWWWWW
WWWWWWWWWWWWF..E...........................XEF.FWWWWWWWWWWWW
WWWWWWWWWWWW.É.E.........FN...............DBE...WWWWWWWWWWWW
WWWWWWWWWWWWF..E..MM....FFNTTT...........DDDE.É.WWWWWWWWWWWW
WWWWWWWWWWWWW.FED.MB...FFFNNNNN......T.D.DDDE..WWWWWWWWWWWWW
WWWWWWWWWWWWWFFED.....FFFFFFFFN......NNNN...EMFWWWWWWWWWWWWW
WWWWWWWWWWWWWFFEFD..........................EFMWWWWWWWWWWWWW
WWWWWWWWWWWWWWFEFFF........................DEDWWWWWWWWWWWWWW
WWWWWWWWWWWWWWFEFFFF.....1.1.1.1.1........DDEDWWWWWWWWWWWWWW
WWWWWWWWWWÊWWWWECFFFF.D............D.DDCC.DDEWWWWWWWWWWWWWWW
WWWWWWWWWWWWWWWEEEEEEEEEEEEEEEEEEEEEEEEEEEEEEWWWÊWWWWWWWWWWW
WWWWWWWWWWWWWWWWWFFFFF..FMFFFD.D..MFFFFDFDMWWWWWWWWWWWWWWWWW
WWWWWWWWWWWWWWWWWWWFFD.É..É...FF.É..É.DFMWWWWWWWWWWWWWWWWWWW
WWWWWWWWWWWWWWÊWWWWWWWD.FD...M.D..FD..WWWWWWWWWWWWWWWWWWWWWW
WWWWWWWWWWWWWWWWWWWWWWWWWWWWWWWWWWWWWWWWWWWÊWWWWWWWWWWWWWWWW
WWWWWWWWWWWWWWWWWWWWWWWWWWWWWWWWWWWWWWWWWWWWWWWWWWWWWWWWWWWW
WWWWWWWWWWWWWWWWWWWWWWWWWWWWWWWWWWWWWWWWWWWWWWWWWWWWWWWWWWWW
WWWWWWWWWWWWWWWWWWWWWWWWWWWWWWWWWWWWWWWWWWWWWWWWWWWWWWWWWWWW
WWWWWWWWWWWWWWWWWWWWWWWWWWWWWWWWWWWWWWWWWWWWWWWWWWWWWWWWWWWW
WWWWWWWWWWWWWWWWWWWWWWWWWWWWWWWWWWWWWWWWWWWWWWWWWWWWWWWWWWWW
WWWWWWWWWWWWWWWWWWWWWWWWWWWWWWWWWWWWWWWWWWWWWWWWWWWWWWWWWWWW
WWWWWWWWWWWWWWWWWWWWWWWWWWWWWWWWWWWWWWWWWWWWWWWWWWWWWWWWWWWW
WWWWWWWWWWWWWWWWWWWWWWWWWWWWWWWWWWWWWWWWWWWWWWWWWWWWWWWWWWWW