WWWWWWWWWWWWWWWWWWWWWWWWWWWWWWWWWWWWWWWWWWWWWWWWWWWWWWWWWWWW
WWWWWWWWWWWWWWWWWWWWWWWWWWWWWWWWWWWWWWWWWWWWWWWWWWWWWWWWWWWW
WWWWWWWWWWWWWWWWWWWWWWWWWWWWWWWWWWWWWWWWWWWWWWWWWWWWWWWWWWWW
WWWWWWWWWWWWWWWWWWWWWWWWWWWWWWWWWWWWWWWWWWWWWWWWWWWWWWWWWWWW
WWWWWWWWWWWWWWWWWWWWWWWWWWWWWWWWWWWWWWWWWWWWWWWWWWWWWWWWWWWW
WWWWWWWWWWWWWWWWWWWWWWWWWWWWWWWWWWWWWWWWWWWWWWWWWWWWWWWWWWWW
WWWWWWWWWWWWWWWWWWWWWWWWWWWWWWWWWWWWWWWWWWWWWWWWWWWWWWWWWWWW
WWWWWWWWWWWWWWWWWWWWWWWWWWWWWWWWWWWWWWWWWWWWWWWWWWWWWWWWWWWW
WWWWWWWWWWWWWWWWWWWWWWWWWWWWWWWWWWWWWWWWWWWWWWWWWWWWWWWWWWWW
WWWWWWWWWWWWWWWWWWWWWWWWWWWWWWWWWWWWWWWWWWWWWWWWWWWWWWWWWWWW
WWWWWWWWWWWWWWWWWWWWWWWWWWWWWWWWWWWWWWWWWWWWWWWWWWWWWWWWWWWW
WWWWWWWWWWWWXXXXXXXXXXXXXXXXXXXXXXXXXXWWWWWWWWWWWWWWWWWWWWWW
WWWWWWWWWWWWNYYC...................BBNWWWWWWWWWWWWWWWWWWWWWW
WWWWWWWWWWWWNYC.........2.2.2.2.2...BNWWWWWWWWWWWWWWWWWWWWWW
WWWWWWWWWWWWNT....NNNN...............NWWWWWWWWWWWWWWWWWWWWWW
WWWWWWWWWWWWN.....aWWNB..............NWWWWWWWWWWWWWWWWWWWWWW
WWWWWWWWWWWWNF..aaaWWNNN....NNNNNN...NWWWWWWWWWWWWWWWWWWWWWW
WWWWWWWWWWWWNF..aWWWWWWa....aWWWWa...NNNNNNNNWWWWWWWWWWWWWWW
WWWWWWWWWWWWNF..aWWWWWWa....aWWWWa......FFCYNWWWWWWWWWWWWWWW
WWWWWWWWWWWWNF..aaaaaaaa....aaaWWa.......FFTNWWWWWWWWWWWWWWW
WWWWWWWWWWWWNF................aaaa........FFNWWWWWWWWWWWWWWW
WWWWWWWWWWWWNF.............................FNWWWWWWWWWWWWWWW
WWWWWWWWWWWWNF......FFF.....................NWWWWWWWWWWWWWWW
WWWWWWWWWWWWNF.....YXXXT......FIIIIIY....XXXNWWWWWWWWWWWWWWW
WWWWWWWWWWWWN.......YBB.......FWWWWWa....aWWWWWWWWWWWWWWWWWW
WWWWWWWWWWWWNC............TY..FWWWWWa....aWWWWWWWWWWWWWWWWWW
WWWWWWWWWWWWNY................FWWaaaa....aaaNWWWWWWWWWWWWWWW
WWWWWWWWWWWWNYT......8.......FFWWaG.........NWWWWWWWWWWWWWWW
WWWWWWWWWWWWNCCB............FFFWWa..........NWWWWWWWWWWWWWWW
WWWWWWWWWWWWNNNN...........FFFFWWa......CY..NWWWWWWWWWWWWWWW
WWWWWWWWWWWWWWWN..CT......aWWFFFF...........NNNNWWWWWWWWWWWW
WWWWWWWWWWWWWWWN........H.aWWFFF.....8......BCCNWWWWWWWWWWWW
WWWWWWWWWWWWWWWN..........aWWFF..............TYNWWWWWWWWWWWW
WWWWWWWWWWWWWWWNaaa....aaaaWWF................YNWWWWWWWWWWWW
WWWWWWWWWWWWWWWWWWa....aWWWWWF..CY............CNWWWWWWWWWWWW
WWWWWWWWWWWWWWWWWWa....aWWWWWF.......BBY.......NWWWWWWWWWWWW
WWWWWWWWWWWWWWWNXXX....CIIIIIF......TXXXC.....FNWWWWWWWWWWWW
WWWWWWWWWWWWWWWN.....................FFF......FNWWWWWWWWWWWW
WWWWWWWWWWWWWWWNF.............................FNWWWWWWWWWWWW
WWWWWWWWWWWWWWWNFF........aaaa................FNWWWWWWWWWWWW
WWWWWWWWWWWWWWWNTFF.......aWWaaa....aaaaaaaa..FNWWWWWWWWWWWW
WWWWWWWWWWWWWWWNYCFF......aWWWWa....aWWWWWWa..FNWWWWWWWWWWWW
WWWWWWWWWWWWWWWNNNNNNNN...aWWWWa....aWWWWWWa..FNWWWWWWWWWWWW
WWWWWWWWWWWWWWWWWWWWWWN...NNNNNN....NNNWWaaa..FNWWWWWWWWWWWW
WWWWWWWWWWWWWWWWWWWWWWN..............BNWWa.....NWWWWWWWWWWWW
WWWWWWWWWWWWWWWWWWWWWWN...............NNNN....TNWWWWWWWWWWWW
WWWWWWWWWWWWWWWWWWWWWWNB...1.1.1.1.1.........CYNWWWWWWWWWWWW
WWWWWWWWWWWWWWWWWWWWWWNBB...................CYYNWWWWWWWWWWWW
WWWWWWWWWWWWWWWWWWWWWWXXXXXXXXXXXXXXXXXXXXXXXXXXWWWWWWWWWWWW
WWWWWWWWWWWWWWWWWWWWWWWWWWWWWWWWWWWWWWWWWWWWWWWWWWWWWWWWWWWW
WWWWWWWWWWWWWWWWWWWWWWWWWWWWWWWWWWWWWWWWWWWWWWWWWWWWWWWWWWWW
WWWWWWWWWWWWWWWWWWWWWWWWWWWWWWWWWWWWWWWWWWWWWWWWWWWWWWWWWWWW
WWWWWWWWWWWWWWWWWWWWWWWWWWWWWWWWWWWWWWWWWWWWWWWWWWWWWWWWWWWW
WWWWWWWWWWWWWWWWWWWWWWWWWWWWWWWWWWWWWWWWWWWWWWWWWWWWWWWWWWWW
WWWWWWWWWWWWWWWWWWWWWWWWWWWWWWWWWWWWWWWWWWWWWWWWWWWWWWWWWWWW
WWWWWWWWWWWWWWWWWWWWWWWWWWWWWWWWWWWWWWWWWWWWWWWWWWWWWWWWWWWW
WWWWWWWWWWWWWWWWWWWWWWWWWWWWWWWWWWWWWWWWWWWWWWWWWWWWWWWWWWWW
WWWWWWWWWWWWWWWWWWWWWWWWWWWWWWWWWWWWWWWWWWWWWWWWWWWWWWWWWWWW
WWWWWWWWWWWWWWWWWWWWWWWWWWWWWWWWWWWWWWWWWWWWWWWWWWWWWWWWWWWW
WWWWWWWWWWWWWWWWWWWWWWWWWWWWWWWWWWWWWWWWWWWWWWWWWWWWWWWWWWWW