WWWWWWWWWWWWWWWWWWWWWWWWWWWWWWWWWWWWWWWWWWWWWWWWWWWWWWWWWWWW
WWWWWWWWWWWWWWWWWWWWWWWWWWWWWWWWWWWWWWWWWWWWWWWWWWWWWWWWWWWW
WWWWWWWWWWWWWWWWWWWWWWWWWWWWWWWWWWWWWWWWWWWWWWWWWWWWWWWWWWWW
WWWWWWWWWWWWWWWWWWWWWWWWWWWWWWWWWWWWWWWWWWWWWWWWWWWWWWWWWWWW
WWWWWWWWWWWWWWWWWWWWWWWWWWWWWWWWWWWWWWWWWWWWWWWWWWWWWWWWWWWW
WWWWWWWWWWWWWWWWWWWWWWWWWWWWWWWWWWWWWWWWWWWWWWWWWWWWWWWWWWWW
WWWWWWWWWWWWWWWWWWWWWWÊWWWWNNNNNWWWWWÊWWWWWWWWWWWWWWWWWWWWWW
WWWWWWWWWWWWWWWWWWWWWWWWWWWC.È..WWWWWWWWWWWWWWWWWWWWWWWWWWWW
WWWWWWWWWWWWWWWWWWWWWWWWWD.FFF...WWWWWWWWWWWWWWWWWWWWWWWWWWW
WWWWWWWWWWWWWWWWWWWWWWFFF.È.....ÈD..WWWWWWWWWWWWWWWWWWWWWWWW
WWWWWWWWWWWWWWWWWWWWWFFF...D.FFF..CYFFFWWWWWWWWWWWWWWWWWWWWW
WWWWWWWWWWWWWWWWEEEEEEEEEEEEEEEEEEEEEEEEEEEWWWWWWWWWWWWWWWWW
WWWWWWWWWÊWWWWWWE....FFFF...YYC...FFFF.D..EWWWWWÊWWWWWWWWWWW
WWWWWWWWWWWWWWWWE....FF......C......FF....EWWWWWWWWWWWWWWWWW
WWWWWWWWWWWWWWW.E.......33333333333......DEWWWWWWWWWWWWWWWWW
WWWWWWWWWWWWWFF.E.........................EYWWWWWWWWWWWWWWWW
WWWWWWWWWWWWWÈ..EMM........wwwww........MME...WWWWWWWWWWWWWW
WWWWWWWWWWWWF...ED......NN.wwwww.NN.......E.È.FFWWWWWWWWWWWW
WWWWWWWWWWWFF..YE.......NB.......BN.......E......WWWWWWWWWWW
WWWWWWWWWW.F...YE.............D...........EFF.FFFÈWWWWWWWWWW
WWWWWWWWWÉ......E...T.................XD..EFF...FFNWWWWWWWWW
WWWWWWWWN..FF.FFE..NNN....D..2.......MMM..EF..Ë.TFNWWWWWWWWW
WWWWWWWWNF..Ë..FE..D.............D........EC......NWWWWWWWWW
WWWWWWWWNT.....CE.........................EF....FWWWWWWWWWWW
WWWWWWWWWW..D..FEFF.....NB.......BN.....FFEF...DFWWWWWWWWWWW
WWWWWWWWWW...FFFEFF.....NN...D...NN.....FFE.F.Y.FWWWWWWWWWWW
WWWWWWWWWWÈCF...E.........................E..FNNNWWWWWWWWWWW
WWWWWWWWWWNNN..FE..MM.D......N........MM..EF.ÈWWWWWWWWWWWWWW
WWWWWWWWWWWWWÈ.FE..Xwwwwww...N...wwwwwwX..EF.WWWWWWWWWWWWWWW
WWWWWWWWWWWWWWF.E...wwwwww.......wwwwww...EWWWWWWWWWWWWWWWWW
WWWWWWWWWWWWWWW.E.......NN.......NN.......EWWWWWWWWWWWWWWWWW
WWWWWWWWWWWWWWWWE................D........EWWWWWWWWWWWWWWWWW
WWWWWWWWWWWWWWWWE...........333..........DEWWWWWWWWWWWWWWWWW
WWWWWWWWWWWWÊWWWEEEEEE..DN.......N...EEEEEEWWWWWWWWWWWWWWWWW
WWWWWWWWWWWWWWWWWWWWWE...NN.www.NN...EWWWWWWWWWWÊWWWWWWWWWWW
WWWWWWWWWWWWWWWWWWWWWE......www......EWWWWWWWWWWWWWWWWWWWWWW
WWWWWWWWWWWWWWWW.F.WWE..D...www......EWW.F.WWWWWWWWWWWWWWWWW
WWWWWWWWWWWWWWWWFÈ.WWEF.....www.....FEWW.ÈFWWWWWWWWWWWWWWWWW
WWWWWWWWWWWWWWWW..FWWEF...YTwwwTY...FEWWFF.WWWWWWWWWWWWWWWWW
WWWWWWWWWWWWWWWWWWWWWEF...D.......D.FEWWWWWWWWWWWWWWWWWWWWWW
WWWWWWWWWWWWWWWWWWWWWEFF.....3.....FFEWWWWWWWWWWWWWWWWWWWWWW
WWWWWWWWWWWWWWWWWWWWWEEEEE.......EEEEEWWWWWWWWWWWWWWWWWWWWWW
WWWWWWWWWWÊWWWWWWWWWWWWWWED.www..EWWWWWWWWWWWWWÊWWWWWWWWWWWW
WWWWWWWWWWWWWWWWWWWWWWWWWE..www.DEWWWWWWWWWWWWWWWWWWWWWWWWWW
WWWWWWWWWWWWWWWWWWWWWWWWBE..1.1..EYWWWWÊWWWWWWWWWWWWWWWWWWWW
WWWWWWWWWWWWWWWWWWWWWWW.CEFF...FFEY.WWWWWWWWWWWWWWWWWWWWWWWW
WWWWWWWWWWWWWWWWWÊWWWWB.FEFFBBBFFEFBCWWWWWWWWWWWWWWWWWWWWWWW
WWWWWWWWWWWWWWWWWWWWWWFF.EEEEEEEEEFF.WWWWWWWWWWWWWWWWWWWWWWW
WWWWWWWWWWWWWWWWWWWWWWWWWWWYY...WWWWWWWWWWWWWWWWWWWWWWWWWWWW
WWWWWWWWWWWWWWWWWWWWWWWWWWWFC.DFWWWWWWWWWWWWWWWWWWWWWWWWWWWW
WWWWWWWWWWWWWWWWWWWWWWWWW.È....FÈ.WWWWWWWWWWWWWWWWWWWWWWWWWW
WWWWWWWWWWWWWWWWWWWWWWWWWFFF.....DWWWWWWWWWWWWWWWWWWWWWWWWWW
WWWWWWWWWWWWWWWWWWWWWWWWWWNFD.FYNWWWWWWWWWWWWWWWWWWWWWWWWWWW
WWWWWWWWWWWWWWWWWWWWWWWWWWN..FFYNWWWWWWWWWWWWWWWWWWWWWWWWWWW
WWWWWWWWWWWWWWWWWWWWWWWWWWNC..FFNWWWWWWWWWWWWWWWWWWWWWWWWWWW
WWWWWWWWWWWWWWWWWWWWWWWWWWWWF..WWWWWWWWWWWWWWWWWWWWWWWWWWWWW
WWWWWWWWWWWWWWWWWWWWWWWWWWWWWWWWWWWWWWWWWWWWWWWWWWWWWWWWWWWW
WWWWWWWWWWWWWWWWWWWWWWWWWWWWWWWWWWWWWWWWWWWWWWWWWWWWWWWWWWWW
WWWWWWWWWWWWWWWWWWWWWWWWWWWWWWWWWWWWWWWWWWWWWWWWWWWWWWWWWWWW
WWWWWWWWWWWWWWWWWWWWWWWWWWWWWWWWWWWWWWWWWWWWWWWWWWWWWWWWWWWW