112200004040400022222
122200000000000022222
222200000000000022222
222200000000000000000
000000000090000000000
000000000000000000000
000000000000000000003
310000000000033000033
330000000000033000033
330000330000333300033
330000331000333200033
330000333000333300033
330000333000333300033
320000333000033000023
220000033000050000022
222000011000050000222
222000010000050000222
222000010000150000222
220000010000330000022
320000330000333000023
330003333000333000033
330003333000333000033
330003333000133000033
330003333000033000033
330000330000000000033
330000330000000000013
300000000000000000000
000000000000000000000
000000000090000000000
000000000000000000000
222220000000000002222
222220000000000002221
222220004040400002211