001110004040402222222
002200000000000222222
002200000000000000222
100000000000000000001
111000000090000000111
001000000000000000100
001000000000000000100
001000000000000000022
000000100000000100022
000000100000002100000
222001100000022100500
222200000000222100500
555200000002222100500
222200000002222100522
222000010022100000522
000000111222110000500
005001111222111100500
005000011222111000000
225000001220010000222
225000022220000002222
005001222200000002555
005001222000000002222
005001220000001100222
000001200000001000000
220001000000001000000
220000000000000000100
001000000000000000100
001000000000000000100
111000000090000000111
100000000000000000001
222000000000000002200
222222000000000002200
222222204040400011100