000000004040400011100
000000000000000011100
0011100000000000W1100
001110022000220000000
001110022090220000000
220000022222220000000
220000022222220000500
111100000000000005500
002200000000000000000
002200000000000000000
000000000000000000000
110000000000000000015
110003333111333300055
000003333000333322000
000000022222222222000
000000022222222222000
000000000220000000000
000222222222200000000
000222222222200000000
000223333000333300000
550003333111333300011
510000000000000000011
000000000000000000000
000000000000000002200
000000000000000002200
005500000000000001111
005000022222220000022
000000022222220000022
000000022090220011100
000000022000220011100
0011W0000000000011100
001110000000000000000
001110004040400000000