........2...2........
.....................
.....................
.....................
.....................
YYYY.................
YYY.......YYYFF......
.........YYYFF....YYY
..........T......YYYY
.....................
.FF..................
.FF..................
.FF..N...........FFFN
.FF..NNNNNNN....NNNNN
......YYY.........CCC
.......C..........c.Y
.c...................
Y............C.......
CCC.........YYY......
NNNNN....NNNNNNN..FF.
NFFF...........N..FF.
..................FF.
..................FF.
.....................
YYYY......T..........
YYY....FFYYY.........
......FFYYY.......YYY
.................YYYY
.....................
.....................
.....................
.....................
........1...1........