.........2.2.........
.....................
NNNNN...........NNNNN
WWW...............WWW
WWW...............WWW
WWW...............WWW
WWW......CY.......WWW
........NNNNN........
.....................
.....................
...CC.FFFFFFFFF.CC...
...CC.FFFFFFFFF.CC...
......FFF...FFF......
....FFFFF...FFFFF....
....FFFF.....FFFF....
.........WWW........Y
MMMM....TWWWT....MMMM
Y........WWW.........
....FFFF.....FFFF....
....FFFFF...FFFFF....
......FFF...FFF......
...CC.FFFFFFFFF.CC...
...CC.FFFFFFFFF.CC...
.....................
.....................
........NNNNN........
WWW.......YC......WWW
WWW...............WWW
WWW...............WWW
WWW...............WWW
NNNNN...........NNNNN
.....................
.........1.1.........