MMMMMM..2...2........
MMMMM................
MMMMM................
MMMY.................
TL..................C
..................YMM
..........FFF..MMMMMM
..........FFF...MMMMM
..................MMM
YY...................
MM.....aaaa..........
MMMMWWWWC.......FFF..
MMMMWWWW........FFF..
MY........FF....FFF..
C.........FFT........
.....................
.....................
.....................
........TFF.........C
..FFF....FF........YM
..FFF........WWWWMMMM
..FFF.......CWWWWMMMM
..........aaaa.....MM
...................YY
MMM..................
MMMMM...FFF..........
MMMMMM..FFF..........
MMY...............K..
C...................T
.................YMMM
................MMMMM
................MMMMM
........1...1..MMMMMM