........2...2........
.....................
.....................
.....................
....MM..........MM...
....MX..........XM...
..........MM.........
..........MM.........
.....................
F...................F
F...................F
FF...MMF...........FF
FF...MMF...........FF
FFF.........XM....FFF
FFF.........MM....FFF
.....................
MMX...............XMM
.....................
FFF....MM.........FFF
FFF....MX.........FFF
FF...........FMM...FF
FF...........FMM...FF
F...................F
F...................F
.....................
.........MM..........
.........MM..........
...MX..........XM....
...MM..........MM....
.....................
.....................
.....................
........1...1........