JJJJJJJ.7.7.7.JJJJJJJ
JJJJJJJ.......JJJJJJJ
JJJJJJJ.......JJJJJJJ
JJJJJJJYY...YYJJJJJJJ
.....................
.....................
CYYY.............YYYC
..C.....YYYYY.....C..
......FFFFFFFFF......
.....FFFFFFFFFFF.....
........2.2.2........
..FF.............FF..
..FF.YYYY...YYYY.FF..
..CFF...........FFC..
..YFF...FFFFF...FFY..
..YYFFFFFFFFFYYFFYY..
YYYYFFFFFF.FFFFFFYYYY
..YYFFYYFFFFFFFFFYY..
..YFF...FFFFF...FFY..
..CFF...........FFC..
..FF.YYYY...YYYY.FF..
..FF.............FF..
........1.1.1........
.....FFFFFFFFFFF.....
......FFFFFFFFF......
..C.....YYYYY.....C..
CYYY.............YYYC
.....................
.....................
JJJJJJJYY...YYJJJJJJJ
JJJJJJJ.......JJJJJJJ
JJJJJJJ.......JJJJJJJ
JJJJJJJ.6.6.6.JJJJJJJ