........2.2.2........
.....................
.....................
FFF..............TL..
FFTT....YY.......T...
FF......YMMM.........
FF...................
FF...................
FF.III.FIMMMMMMWWWWMM
FF.....FIIIMMMMWWWWYY
.......FFFFFFFFF.....
.......FFFFFFFFF.....
........C............
.....................
...............IFF...
...............IFF...
.....................
...FFI...............
...FFI...............
.....................
............C........
.....FFFFFFFFF.......
.....FFFFFFFFF.......
YYWWWWMMMMIIIF.....FF
MMWWWWMMMMMMIF.III.FF
...................FF
...................FF
.........MMMY......FF
.K.T.......YY....TTFF
...T..............FFF
.....................
.....................
........1.1.1........