WWWWWWWWWWWWWWWWWWWWWWWWWWWWWWWWWWWWWWWWWWWWWWWWWWWWWWWWWWWW
WWWWWWWWWWWWWWWWWWWWWWWWWWWWWWWWWWWWWWWWWWWWWWWWWWWWWWWWWWWW
WWWWWWWWWWWWWWWWWWWWWWWWWWWWWWWWWWWWWWWWWWWWWWWWWWWWWWWWWWWW
WWWWWWWWWWWWWWWWWWWWWWWWWWWWWWWWWWWWWWWWWWWWWWWWWWWWWWWWWWWW
WWWWWWWWWWWWWWWWWWWWWWWWWWWWWWWWWWWWWWWWWWWWWWWWWWWWWWWWWWWW
WWWWWWWWWWWWWWWWWWWWWWWWWWWWWWWWWWWWWWWWWWWWWWWWWWWWWWWWWWWW
WWWWWWWWWWWWWWWWWWWWWWWWWWWWWWWWWWWWWWWWWWWWWWWWWWWWWWWWWWWW
WWWWWWWWWWWWWWWWWWWWWWWWWWWWWWWWWWWWWWWWWWWWWWWWWWWWWWWWWWWW
WWWWWWWWWWWWWWWWWWWWWWWWWWWWWWWWWWWWWWWWWWWWWWWWWWWWWWWWWWWW
WWWWWWWWWWWWWWWWWWWWWWWWWWWWWWWWWWWWWWWWWWWWWWWWWWWWWWWWWWWW
WWWWWWWWWWWWWWWWWWWWWWWWWWWWWWWWWWWWWWWWWWWWWWWWWWWWWWWWWWWW
WWWWWWWWWWWWWWWWWWWWWWWWWWWWWWWWWWWWWWWWWWWWWWWWWWWWWWWWWWWW
WWWWWWWWWWWWWWWWWWWWWWWWWWWÊWWWWWWWWFF..WWWWWWWWWWWWWWWWWWWW
WWWWWWWWWWWWWWWWWWWWWWWWWWWWWWWÊWWW....È.WWWWWWWWWWWWWWWWWWW
WWWWWWWWWWWWWWWWWWWW..C.WWWWWWWWWWW..Ë...WWWWWWÊWWWWWWWWWWWW
WWWWWWWWWWWWWWWWWWW.É..È.WWWWWWWWWF.....CWWWWWWWWWWWWWWWWWWW
WWWWWWWWWWWÊWWWWWW....FFFWWWWWWWFFT....FFWWWWWWWWWWWWWWWWWWW
WWWWWWWWWWWWWWWEEEEEEEEEEEEEEEEEEEEEEEEEEEEEEWWWWWWWWWWWWWWW
WWWWWWWWWWWWWWWE33v....FFF........FFF....v33EWWWWWWWWWWWWWWW
WWWWWWWWWWWWWWWE33v......................v33EWWWWWWWWWWWWWWW
WWWWWWWWWWWWWWEEvvv....WWW........WWW....vvvEEWWWWWWWWWWWWWW
WWWWWWWWWÊWWWWE........WWW........WWW........EWWWÊWWWWWWWWWW
WWWWWWWWWWWWWWE........vvv........vvv........EWWWWWWWWWWWWWW
WWWWWWWWWWWWEEE..............vv..............EEEWWWWWWWWWWWW
WWWWWWWWWWWFE................vv................EWWWWWWWWWWWW
WWWWWWWWWWFFE......WWW...............WWW.......EWWWWWWWWWWWW
WWWWWWWW....E......WWW...............WWW.......E.WWWWWWWWWWW
WWWWWWWC..Ë.E..................................E..WWWWWWWWWW
WWWWWWW....FE..FFF...........2............FFF..E.È.WWWWWWWWW
WWWWWWW....FE..FWW........................WWF..EF..YWWWWWWWW
WWWWWWWW....E..FWW........................WWF..EF...WWWWWWWW
WWWWWWWWW.É.E..FFF........................FFF..EF.È.WWWWWWWW
WWWWWWWWWWFFE..................................E....WWWWWWWW
WWWWWÊWWWWWWE.......WWW...............WWW......E.È.FWWWWWWWW
WWWWWWWWWWWWE.......WWW...............WWW......E..FFWWWWWWWW
WWWWWWWWW...E..................................EWWWWWWWWWWWW
WWWWWWWW..È.EEE..............................EEEWWWWWWWWWWWW
WWWWWWWWFF...FE........vvv........vvv........EWWWWWWWWWWWWWW
WWWWWWWWWF.É.FE........WWW..1..1..WWW........EWWWWWÊWWWWWWWW
WWWWWWWWW....FEEvvv....WWW........WWW....vvvEEWWWWWWWWWWWWWW
WWWWWWWWWWWWWWWE33v......................v33EWWWWWWWWWWWWWWW
WWWWWWWWWWWWWWWE33v......................v33EWWWWWWWWWWWWWWW
WWWWWWWWWWWWWWWEEEEEEEEEEEEEEEEEEEEEEEEEEEEEEWWWWWWWWWWWWWWW
WWWWWWWWWWÊWWWWWWFFF.......FFFWWWFF..FF.....WWWÊWWWWWWWWWWWW
WWWWWWWWWWWWWWWWWWYF....Y..TFWWWWWFT.È...É..WWWWWWWWWWWWWWWW
WWWWWWWWWWWWWWWWWWWF..Ë....FWWWWWWF.........WWWWWWWWWWWWWWWW
WWWWWWWWWWWWWWWÊWWWC.....È.FWWWÊWWWWFF.È..WWWWWWWWWWWWWWWWWW
WWWWWWWWWWWWWWWWWWWWFFF....WWWWWWWWWWW....WWWWWWWWWWWWWWWWWW
WWWWWWWWWWWWWWWWWWWWWWWWWWWWWWWWWWWWWWWWWWWWWWWWWWWWWWWWWWWW
WWWWWWWWWWWWWWWWWWWWWWWWWWWWWWWWWWWWWWWWWWWWWWWWWWWWWWWWWWWW
WWWWWWWWWWWWWWWWWWWWWWWWWWWWWWWWWWWWWWWWWWWWWWWWWWWWWWWWWWWW
WWWWWWWWWWWWWWWWWWWWWWWWWWWWWWWWWWWWWWWWWWWWWWWWWWWWWWWWWWWW
WWWWWWWWWWWWWWWWWWWWWWWWWWWWWWWWWWWWWWWWWWWWWWWWWWWWWWWWWWWW
WWWWWWWWWWWWWWWWWWWWWWWWWWWWWWWWWWWWWWWWWWWWWWWWWWWWWWWWWWWW
WWWWWWWWWWWWWWWWWWWWWWWWWWWWWWWWWWWWWWWWWWWWWWWWWWWWWWWWWWWW
WWWWWWWWWWWWWWWWWWWWWWWWWWWWWWWWWWWWWWWWWWWWWWWWWWWWWWWWWWWW
WWWWWWWWWWWWWWWWWWWWWWWWWWWWWWWWWWWWWWWWWWWWWWWWWWWWWWWWWWWW
WWWWWWWWWWWWWWWWWWWWWWWWWWWWWWWWWWWWWWWWWWWWWWWWWWWWWWWWWWWW
WWWWWWWWWWWWWWWWWWWWWWWWWWWWWWWWWWWWWWWWWWWWWWWWWWWWWWWWWWWW
WWWWWWWWWWWWWWWWWWWWWWWWWWWWWWWWWWWWWWWWWWWWWWWWWWWWWWWWWWWW