JJJJJJJJJJJJJJJJJJJJJ
JJJJJJJJJJJJJJJJJJJJJ
JJJJJJJJJJJJJJJJJJJJJ
JJJJJJJJJJJJJJJJJJJJJ
JJJJJJJJJJJJJJJJJJJJJ
JJJJJJJJJJJJJJJJJJJJJ
JJJJJJJJJJJJJJJJJJJJJ
JJJJJJJJJJJJJJJJJJJJJ
FFFFMFFFMFFFMFFFMFFFF
FFFFMFFFMFFFMFFFMFFFF
.....................
.....................
.....................
.....................
..1....M.....M....2..
.......M.....M.......
..1....M.....M....2..
.......M.....M.......
..1....M.....M....2..
.....................
.....................
.....................
.....................
FFFFMFFFMFFFMFFFMFFFF
FFFFMFFFMFFFMFFFMFFFF
JJJJJJJJJJJJJJJJJJJJJ
JJJJJJJJJJJJJJJJJJJJJ
JJJJJJJJJJJJJJJJJJJJJ
JJJJJJJJJJJJJJJJJJJJJ
JJJJJJJJJJJJJJJJJJJJJ
JJJJJJJJJJJJJJJJJJJJJ
JJJJJJJJJJJJJJJJJJJJJ
JJJJJJJJJJJJJJJJJJJJJ